a	an
abandon	abandoned	abandoning	abandonment	abandons
abide	abides	abided	abiding	abidance	abidances
abject	abjectness	abjectly
able	ability	abler	ablest	ably	abilities	unable	inability
abound	abounds	abounded	abounding
about
above
abrupt	abrupter	abruptest	abruptness	abruptly
absence	absences
absent	absented	absenting	absents	absentee	absentees	absenteeism	absently
absolute	absolutely	absolutist	absolutists
absorb	absorbed	absorbing	absorbs	absorption	absorptions	absorbent	absorbency
absurd	absurder	absurdest	absurdness	absurdly	absurdity	absurdities
accent	accented	unaccented	accenting	accents
accept	acceptability	acceptable	acceptably	unacceptable	acceptance	accepted	accepting	accepts	unacceptably
access	accessed	accesses	accessibility	accessible	accessing	inaccessible
accident	accidents	accidental	accidentally
accompany	accompanied	accompanies	accompaniment	accompanying	unaccompanied
accomplish	accomplishes	accomplished	accomplishing	accomplishment	accomplishments
accord	accorded	accords	accordance
according	accordingly
account	accounted	accounting	accounts
accountable	unaccountable	unaccountably	accountability	accountabilities
accumulate	accumulated	accumulating	accumulation	accumulates	accumulator	accumulators
accurate	accuracy	accuracies	inaccuracy	inaccuracies	accurately	inaccurate	inaccurately
accuse	accusing	accusingly	accuses	accused	accusation	accusations	accuser	accusers
accustom	unaccustomed	accustomed	accustoms	accustoming
ache	aches	ached	aching	achy
achieve	achievable	unachievable	achieved	achievement	achievements	achiever	achievers	achieves	achieving
acknowledge	acknowledged	unacknowledged	acknowledges	acknowledging	acknowledgement	acknowledgements	acknowledgment	acknowledgments
acquaint	acquaints	acquainted	acquainting	acquaintance	acquaintances	acquaintanceship	acquaintanceships
acquiesce	acquiesces	acquiesced	acquiescing	acquiescence	acquiescences	acquiescent	acquiescently
acquire	acquired	unacquired	acquires	acquiring	acquisition	acquisitions	acquirer	acquirers
acre	acres	acreage
acrid	acridness	acridly	acridity
across
act	acted	acting	action	inaction	actions	actionable	acts	actor	actors	actress	actresses
active	actively	activities	activity	inactive	inactivity	activist	activists	activism
actual	actually	actuality
acute	acutely	acuteness
add	added	adding	addition	additional	additionally	additive	additives	additions	adds
address	addressed	addresses	addressing	addressee	addressees
adequate	adequacy	adequately	inadequacies	inadequacy	inadequate	inadequately
adhesive	adhesives
adjust	adjusted	adjusting	adjusts	adjustment	adjustments	adjustable	nonadjustable	adjuster	adjusters
admire	admiring	admires	admired	admirable	admirably	admiration	admirer	admirers	admiringly
admit	admission	admissions	admittedly	admits	admitted	admitting	admissible	admissibly	inadmissible	admittance	readmit	readmitted	readmitting	readmits	readmittance	readmission	admissibility	admissibilities	inadmissibility
admonish	admonishes	admonished	admonishing	admonishment	admonishments	admonition	admonitions
adorn	adorns	adorned	unadorned	adorning	adornment	adornments
advance	advanced	advances	advancement	advancing
advantage	advantages	disadvantage	disadvantages	advantaging	advantaged	disadvantaged	advantageous	disadvantageous	disadvantageously	advantageously
advent	advents
adventure	adventures	adventurer	adventurers	adventurous	misadventure	misadventures
advertise	advertising	advertises	advertiser	advertisers	advertised	advertisement	advertisements	advertize	advertizing	advertizes	advertizer	advertizers	advertized	advertizement	advertizements	ad	ads	advert	adverts
advice
advise	advising	advises	advisers	adviser	advised	advisable	advisably	inadvisable	advisor	advisors	advisory
affair	affairs
affirmative	affirmatives	affirmatively
afford	afforded	affording	affords	affordable	unaffordable
afraid	unafraid
afresh
after	afterward	afterwards
afternoon	afternoons
again
against
agape
age	aged	ages	aging	ageing	ageism	ageist	ageless	ager	agers
agent	agency	agencies	agents
aggravate	aggravates	aggravated	aggravating	aggravation
aghast
ago
agony	agonies	agonise	agonised	agonises	agonising	agonisingly	agonize	agonized	agonizes	agonizing	agonizingly
agree	agreed	agreeing	agreement	agreements	agrees	agreeable	agreeably	disagreeably	disagreements	disagree	disagreeable	disagreed	disagreeing	disagreement	disagrees
ahead
aid	aided	aiding	aids	unaided
aim	aims	aiming	aimed	aimless	aimlessness	aimlessly
air	airy	airier	airiest	airiness	airily	airless	airs	aired	airing	airings	midair
aisle	aisles
akin
alacrity	alacrities
alarm	alarmed	alarming	alarmingly	alarms	alarmist	alarmists
alight
alike
alive
all
allegiance	allegiances
allot	allotting	allotted	allots	allotment	allotments
allow	allowance	allowances	allowed	allowing	allows	allowable
allure	allured	allures	alluring	alluringly
almighty
almost
aloft
alone
along
aloof	aloofness	aloofly
aloud
already
also
alter	alterable	alteration	alterations	altered	altering	alters	unalterable	unaltered
alternate	alternating	alternates	alternated	alternately	alternation	alternations	alternator	alternators
although
altogether
always
amateur	amateurs	amateurish
amaze	amazes	amazed	amazing	amazingly	amazement
america	american	americans	americanise	americanised	americanising	americanisation	americanize	americanized	americanizing	americanization
ammonia	ammonias	ammonium
among	amongst
amount	amounted	amounting	amounts
ample	amply
amuse	amuses	amused	unamused	amusing	amusingly	amusement	amusements
analyse	analysed	analyser	analysers	analyses	analysing	analysis	analyst	analysts	analytic	analytical	analytically	analyze	analyzed	analyzes	analyzing
and
angel	angels	angelic	angelically
anger	angers	angering	angered
angle	angles	angling	angled
angry	angrily	angrier	angriest
angular	angularity	angularities
animal	animals
ankle	ankles
annihilate	annihilated	annihilates	annihilating	annihilation	annihilations
announce	announced	announcement	announcements	announcer	announcers	announces	announcing	unannounced
annoy	annoys	annoyed	annoying	annoyance	annoyances
another
answer	answered	unanswered	answering	answers	answerable	unanswerable
antagonism	antagonisms
antagonist	antagonists	antagonistic	antagonistically
anticipate	anticipated	anticipates	anticipating	anticipation	unanticipated	anticipatory
anxious	anxiously	anxiety	anxiety	anxieties
any	anybody	anyhow	anymore	anyone	anything	anyway	anywhere	anytime
apart
apathy	apathies	apathetic	apathetically
aperture	apertures
apology	apologize	apologies	apologetic	apologetically	apologist	apologists	apologizes	apologized	apologise	apologising	apologizing	apologises	apologised
apoplectic	apoplectically	apoplexy
appal	appalled	appalling	appals	appallingly
apparent	apparently
appeal	appealed	appealing	appeals
appear	appearance	appeared	appearing	appears	appearances	reappear	reappears	reappeared	reappearing	reappearance	reappearances
appetite	appetites
applause	applauses
apply	application	applications	applied	applies	applicable	applying	applicant	applicants	applicability	applicator	applicators
appreciate	appreciable	appreciably	appreciated	appreciates	appreciating	appreciation	unappreciated	appreciative	unappreciative	appreciatively
apprehension	apprehensions
apprehensive	apprehensiveness	apprehensively
apprise	apprised	apprising	apprize	apprized	apprizing
approach	approachable	approached	approaches	approaching	unapproachable
approve	approving	approves	approved	approval	approvals	approvingly
apt	apter	aptest	aptness	aptly	inapt	inaptness	inaptly
arch	arching	arches	arched
archive	archived	archiving	archives	archival	archivist	archivists
area	areas
arena	arenas
argue	arguing	argues	argued	arguable	arguably	unarguably	argument	arguments
arid	aridly	aridity	aridities
arise	arisen	arises	arose	arising
arm	armed	arms	unarmed	armful
around
arraign	arraigns	arraigned	arraigning	arraignment
arrange	arranged	arranging	arranges	arrangement	arrangements
array	arrayed	arraying	arrays
arrive	arrival	arrivals	arrived	arrives	arriving
art	arts	artist	artistic	artists	artistically	arty
article	articles
as
ascend	ascends	ascended	ascending	ascendance	ascendances	ascendant	ascendants	ascendent	ascendancy	ascendancies
ascent	ascents
ascii
ash	ashes	ashen
ashamed	unashamed	unashamedly	ashamedly
aside
ask	asked	unasked	asking	asks
asleep
aspect	aspects
aspire	aspires	aspired	aspiring	aspiration	aspirations	aspirant	aspirants
assail	assails	assailed	assailing	assailable	unassailable	assailant	assailants
assassinate	assassinated	assassinates	assassinating	assassination	assassinations
assay	assays	assayed	assaying	assayer	assayers
assemble	assembled	assembles	assemblies	assembling	assembly	assembler	assemblers	assemblage
assert	asserted	assertion	assertions	asserting	asserts	assertive	assertiveness	unassertive	assertively
assign	assigned	assigning	assignment	assignments	assigns	reassign	reassigned	reassigning	reassigns	unassigned	reassignment	assignee	assignees
assist	assistance	assistant	assistants	assisted	assisting	assists	unassisted
associate	associates	associated	associating	associative	associatively	associations	association	disassociate	disassociated
assorted
assure	assurance	assurances	assured	assuredly	assures	assuring	reassure	reassured	reassures	reassuring	reassuringly	reassurance	reassurances
astonish	astonishes	astonished	astonishing	astonishment	astonishments	astonishingly
astound	astounds	astounded	astounding
astray
astute	astuteness	astutely
at
atmosphere	atmospheric	atmospheres
attach	attached	attaches	attaching	attachment	attachments	unattached
attack	attacked	attacking	attacks	attacker	attackers
attempt	attempted	unattempted	attempting	attempts
attend	attends	attending	attended	unattended	attendant	attendants	attendance	attendances	attention	attentions	attender	attenders
attentive	attentiveness	attentively	inattentive	inattentiveness	inattentively
attenuate	attenuates	attenuated	attenuating	attenuation	attenuations	attenuative
attitude	attitudes	attitudinal
audible	audibly	inaudible	inaudibly
audience	audiences
august	aug
author	authored	authoring	authorial	authors	authorship
authority	authoritative	authoritatively	authoritativeness	authorities
automatic	automatically
available	availability	unavailability	unavailable
avalanche	avalanches
avenue	avenues
aver	avers	averred	averring
averse	aversive	aversion	aversions	aversely
avoid	avoids	avoiding	avoided	avoidance	avoidable	unavoidable	unavoidably
await	awaited	awaiting	awaits
awake	awaken	awoken	awakens	awakened	awakening	awakes	awoke
aware	awareness	unaware	unawares
away
awe	awed	awing	awes
awkward	awkwardly	awkwardness	awkwardnesses
axle	axles
ay	aye	ayes
b
baby	babies	babyish
back	backed	backing	backs	backbone	backwards	backward	backwardness	backwardnesses
background	backgrounds	backgrounded	backgrounding	backer	backers
bad	badly	badness	baddy	baddies
baffle	baffles	baffled	baffling	baffler	bafflers	bafflement	bafflements
bag	bags	bagging	bagged	baggage	baggy	baggier	baggiest	bagginess	baggily
balance	balancing	balances	balanced	imbalance	imbalances	unbalanced	unbalance	unbalances	unbalancing
balcony	balconies
bald	balding	balder	baldest	baldness	baldly
bale	bales	baleful	balefulness	balefully
balk	balks	balked	balking
ball	balls
bandage	bandages	bandaged	bandaging	unbandaged
banish	banishes	banished	banishing	banishment	banishments
banjo	banjos	banjoes
bank	banked	banker	bankers	banking	banks	interbank	bank_1	bank_2
banter	bantering	bantered	banters
bar	bars	barred	unbarred	barring
barb	barbs	barbed
barbaric	barbarically
barbarous	barbarously
bare	baring	bares	bared	barely	bareness
barefaced	barefacedly
bargain	bargains	bargaining	bargained
bark	barks	barked	barking
barn	barns
barren	barrener	barrenest	barrenness
barrier	barriers
base	based	baseless	bases	basic	basics	basically	basing
bash	bashes	bashed	bashing
bashful	bashfully	bashfullness
basin	basins
bask	basks	basked	basking
bass	basses	bassist	bassists
batch	batches
bath	baths
bathe	bathes	bathed	bathing	bather	bathers
battered	battering
battery	batteries
battle	battled	battles	battling	battler	battlers
be	am	are	aren	ain	been	is	isn	re	s	was	wasn	were	weren	being	beings	bein	twas	tis
bead	beads	beaded	beading	beady	beadier	beadiest
beam	beams	beamed	beaming
bear	bearing	bearings	bearable	unbearable	bears	bore	born	reborn	unborn	borne	bearer	bearers	unbearably	bearably
beat	beats	beating	beatings	beaten	unbeaten	unbeatable	beater	beaters
beauty	beautiful	beautifully	beauties
because	cos	coz
beckon	beckons	beckoned	beckoning
become	became	becomes	becoming
bed	bedroom	bedrooms	bedroomed	bedding	bedded	beds
bedside	bedsides
befit	befitting	befitted	befits
before
beforehand
beg	begs	begging	begged	beggars	beggar
begin	began	beginner	beginners	beginning	beginnings	begins	begun
behind
behold	beheld	beholden	beholds	beholding	beholder	beholders
belated	belatedly
belie	belies	belied	belying
belief	beliefs
believe	believed	believes	believing	disbelief	believable	unbelievable	unbelievably	believer	believers	unbeliever	unbelievers	disbelievingly	disbelieving	disbelieved	disbelieves	disbeliever	disbelievers	unbelief	unbelieving	unbelievingly	disbelieve
bell	bells
belligerent	belligerents	belligerently	nonbelligerent
belly	bellies	bellied
belong	belonged	belonging	belongings	belongs
beloved
below
belt	belts	belted	unbelted	belting
bench	benches	bencher	benchers
bend	bending	bent	bends	bendable	unbending	bended
beneath
benefit	beneficial	beneficially	beneficiary	beneficiaries	benefitted	benefitting	benefited	benefiting	benefits
benevolent	benevolently	benevolence	benevolences
bereft
beside	besides
best	better	betterment	betterments
bet	betting	bets
betray	betrays	betrayed	betraying	betrayer	betrayers	betrayal	betrayals
between
betwixt
bewilder	bewildered	bewildering	bewilders	bewilderment
beyond
bid	bidding	bids	bidder	bidders
big	bigger	bigness	biggest	biggish
bill	bills	billed	billing
bin	bins
binary
bind	binds	binding	binders	binder	bound	unbound
birch	birches
bird	birds
birth	births	birthdays	birthday
bit	bits
bitter	bitterness	bitterly	bitterest	bitterer
black	blacker	blackest	blackly	blacken	blackened	blackening	blackens	blackness	blacks	blackish	blacking	blacked
blackjack
blacksmith	blacksmiths
blame	blaming	blames	blamed	blameless	blamelessly
blanch	blanches	blanched	blanching
bland	blander	blandest	blandness	blandly
blank	blankly	blanked	blanks	blanking
blanket	blanketed	blanketing	blankets
blaspheme	blasphemed	blaspheming	blasphemes	blasphemous	blasphemously
blast	blasted	blasting	blasts	blaster
blaze	blazing	blazed	blazes
bleach	bleached	bleaches	bleaching
bleak	bleaker	bleakest	bleakness	bleakly
blight	blights	blighted	blighting
blind	blinds	blindly	blinding	blinded	blindness
blink	blinks	blinked	blinking	blinker	blinkered	blinkers	unblinking
blithe	blithely
block	blocks	blocking	blocked	unblocked	blockage	blockages	blocker	blockers
blood	bled	bleed	bleeding	bleeds	blooded	bloody	bloodied	bloodying	bloodies	bloodiness	bloodless	bloodlessness	bloodlessly
blossom	blossomed	blossoming	blossoms	blossomy
blot	blotting	blotted	blots	blotter	blotters
blotch	blotches	blotchy	blotchier	blotchiest
blouse	blouses
blow	blew	blowing	blows	blown	blower	blowers
blue	blueness	bluer	bluest	bluish	bluey	blues
bluff	bluffs	bluffly
blunder	blundered	blundering	blunders
blur	blurring	blurred	blurs
blurt	blurts	blurted	blurting
bluster	blusters	blustered	blustering	blusterer	blusterers
board	boarded	boarding	boards	boarder	boarders
boast	boasts	boasting	boasted	boastful
bobbed	bobbing	bobs
bobby	bobbies
body	bodies	bodily	bodied
boil	boils	boiling	boilers	boiler	boiled
bold	boldness	boldly	boldest	bolder
bolt	bolted	bolting	bolter	bolters	bolts
bone	boning	bones	boned	bony	bonier	boniest	boniness
book	books	booklet	booklets	bookish	booking	booked	bookings
boot	boots	booted	booting
border	borders	bordering	bordered
boring	bores	bored	boringly	boredom
borrow	borrows	borrowing	borrowings	borrowed	unborrowed	borrower	borrowers
boss	bosses	bossy
both
bother	bothered	bothering	bothers
bottle	bottling	bottles	bottled	unbottled
bottom	bottoms	bottomed	bottoming	bottomless
bounce	bounces	bounced	bouncing	bouncer	bouncers	bouncy	bouncier	bounciest	bounciness	bouncily
bounds	bounding	bounded	boundless	boundlessly	unbounded
bout	bouts
bow	bows	bowing	bowed	unbowed
bowl	bowled	bowling	bowls	bowler	bowlers
box	boxes	boxed	boxing	boxer	boxers
boy	boyhood	boys	boyish
bracket	brackets
brain	brains	brainy	brainier	brainiest	braininess	brainless
branch	branches	branched	branching
brass	brassy
brave	braving	braves	bravely	braved	bravery	braveness	braver	bravest
brawl	brawls	brawled	brawling	brawler	brawlers
breach	breached	breaches	breaching
breadth
break	breaking	breakage	breakages	breaks	broke	broken	unbreakable	outbreaks	outbreak	unbroken	breaker	breakers
breakfast	breakfasts	breakfasting	breakfasted
breast	breasts	breasted	breasting
breath	breaths	breathlessly	breathless	breathy
breathe	breathing	breathes	breathed	unbreathing	breathable	unbreathable
breed	bred	breeding	breeder	breeders	breeds
brevity	brevities
brew	brews	brewed	brewing	brewings	brewer	brewers	brewery	breweries
brick	bricks
bride	brides	bridal
brief	briefed	briefing	briefly	briefs
bright	brighten	brightened	brightening	brightens	brighter	brightest	brightly	brightness
brilliant	brilliantly
brim	brimming	brims	brimless	brimful
bring	bringing	brings	brought
brisk	brisker	briskest	briskness	briskly
broad	broadly	broader	broadest	broaden	broadened	broadening	broadens
broadcast	broadcasts	broadcasted	broadcasting	broadcaster	broadcasters
brood	brooded	broods	brooding	broodingly	broody	broodier	broodiest	broodiness	broodily
brook	brooks	brooklet	brooklets
brow	brows
brown	browns	browning	browned	browny	brownish	browner	brownest
bruise	bruised	bruising	bruisings	bruises
brush	brushing	brushes	brushed	unbrushed
brute	brutal	brutally	brutality	brutalities	brutalize	brutalizes	brutalized	brutalizing	brutalization	brutalise	brutalises	brutalised	brutalising	brutalisation	brutish	brutes
bubble	bubbled	bubbling	bubbles	bubbly
bucket	buckets	bucketful	bucketsful
buckle	buckles	buckled	buckling	buckler	bucklers	unbuckle	unbuckles	unbuckled	unbuckling
buggy	buggies
build	builder	builders	building	buildings	builds	built	unbuilt
bulge	bulges	bulged	bulging
bulk	bulky
bunch	bunched	bunching	bunches
bundle	bundled	bundling	bundles
buoy	buoyed	buoying	buoys	buoyant	buoyantly	buoyancy	buoyancies
burden	burdened	burdening	burdens	unburdened	unburden	unburdening	unburdens
burn	burned	burning	burnings	burns	burnt	burnable	unburnable	burner	burners
burnish	burnishes	burnished	burnishing	burnisher	burnishers
burr	burrs
burrow	burrowed	burrowing	burrows
burst	bursts	bursting
bury	burying	buries	buried	burial	burials
bush	bushes	bushy
business	businesses	businessmen	unbusinesslike	businesslike	businessman	businesswoman	businesswomen
busted	busting	buster	busters
busy	busily	busiest	busier	busied	busies	busying
but
butt	butted	butting	butts
button	buttons	buttoning	buttoned	unbutton	unbuttoning	unbuttons	unbuttoned
buy	bought	buying	buys	buyer	buyers	rebuild	rebuilding	rebuilt	prebuilt
buzz	buzzed	buzzes	buzzing	buzzy	buzzer	buzzers
buzzard	buzzards
by
c
cackle	cackles	cackled	cackling	cackler	cacklers
calamity	calamities	calamitous
calculate	calculator	calculators	calculating	calculates	calculated	calculation	calculations
calendar	calendars
calibre	calibres
calico	calicoes	calicos
call	called	calling	calls	caller	callers
calm	calms	calmly	calming	calmed	calmness	calmer	calmest
camaraderie	camaraderies
camp	camped	camping	camps	camper	campers
campaign	campaigned	campaigning	campaigns	campaigner	campaigners
can	cannot	cans	
canada	canadian	canadians
candid	candidness	candidly
cannon	cannons
canvas	canvases
cap	caps	cappings	capping	capped
capable	capably	capabilities	capability	incapable	incapability
capacity	capacities	incapacity	incapacities
capital	capitals
captain	captains	captained	captaining	capt	capts	captaincy	captaincies
caption	captioned	captioning	captions
car	cars
card	cards
cardboard
care	cared	uncared	careful	carefully	careless	carelessness	cares	caring	carelessly	uncaring	carer	carers
caress	caresses	caressed	caressing
carpet	carpeted	carpeting	carpets
carriage	carriages
carry	carried	carrier	carriers	carries	carrying
cartoon	cartoons	cartoonist	cartoonists
cascade	cascaded	cascades	cascading
case	cases	cased	casing	casings
cash	cashes	cashed	cashing
cast	casting	castings	casts
cat	cats	catlike
cataclysm	cataclysms	cataclysmic
catalogue	catalogues	catalogued	cataloguing	catalog	catalogs
catapult	catapulted	catapulting	catapults
cataract	cataracts
catastrophe	catastrophes	catastrophic	catastrophically
catch	catches	catching	caught	uncaught	catcher	catchers	catchy
cause	caused	causes	causing	causation	causative
caution	cautions	cautioning	cautioned	cautious	cautiously	cautionary
cave	caving	caves	caved
cease	ceased	ceaseless	ceaselessly	ceases	ceasing	unceasing
celebrate	celebrated	uncelebrated	celebrating	celebrates	celebration	celebrations	celebratory
celerity
cemetery	cemeteries
censure	censured	censuring	censures
centre	center	centerist	centerists	centers	centred	centered	central	centralism	centrally	centrality	centralities	centres	centrist	centrists	centralise	centralises	centralised	centralising	centralisation	centralized	centralize	centralizes	centralizing	centralization
ceremony	ceremonies	ceremonial	ceremonially	ceremonious	ceremoniously	unceremoniously
certain	certainly	certainty	uncertain	uncertainties	uncertainty	uncertainly
cessation	cessations
chair	chairs	chaired	chairing
chalk	chalks	chalked	chalking	chalky	chalkier	chalkiest	chalkiness
challenge	challenged	unchallenged	challenger	challengers	challenges	challenging
champion	champions	championship	championships	championed	championing	champ	champs
chance	chanced	chances	chancing
change	changed	changes	changing	changeable	unchanged	unchangeable	unchangeably	unchanging	changer	changers
chant	chants	chanted	chanting	chanter	chanters
chaotic	chaotically
chapter	chapters	chapt	ch
charge	charged	uncharged	charges	charging	charger	chargers	chargeable	nonchargeable
charitable	charitably	uncharitably	charitableness	uncharitable
charity	charities
charm	charms	charming	charmed	charmless	charmingly	charmer	charmers
chase	chased	chases	chasing	chaser	chasers
chatter	chatters	chattered	chattering	chatterer	chatterers
cheap	cheapness	cheaply	cheapest	cheaper	cheapen	cheapening	cheapened	cheapens
cheat	cheats	cheated	cheating	cheater	cheaters
check	checks	checking	checked	unchecked
cheek	cheeks
cheer	cheers	cheered	cheering	cheerless	cheerlessness	cheerlessly	cheery	cheerier	cheeriest	cheeriness	cheerily	cheerful	cheerfulness	cheerfully
cherub	cherubs	cherubic
chest	chests
chew	chews	chewed	chewing	chewer	chewers	chewy	chewier	chewiest
chief	chiefs	chiefly
child	children	childish	childhood	childless	childlike
chill	chilled	chilling	chillingly	chiller	chills	chilly	chillier	chilliest	chilliness
chimney	chimneys
chin	chins	chinless
chip	chips	chipped	chipping	chippings
chirp	chirps	chirped	chirpy	chirpily
chisel	chisels	chiseling	chiseled
choice	choices
choke	chokes	choked	choking	choker	chokers
choose	chooses	choosing	chose	chosen	unchosen	choosy
chortle	chortles	chortled	chortling	chortler	chortlers
chorus	choruses
christ	christian	christians	christianity	christendom
christen	christens	christened	christening
chub	chubs
chubby	chubbier	chubbiest	chubbiness
chuckle	chuckles	chuckled	chuckling	chuckler
church	churches
circle	circled	circles	circling	circular
circumstance	circumstances	circumstantial	circumstantially	circumstantiality
citizen	citizens	citizenship	citizenships
city	cities
civilise	civilised	civilising	civilises	civilize	civilized	civilizing	civilizes	civilisation	civilisations	civilization	civilizations	uncivilized	uncivilised
clad	cladding	clads	unclad
claim	claimed	claiming	claims	unclaimed	claimant	claimants
clamber	clambers	clambered	clambering	clamberer	clamberers
clamour	clamours	clamoured	clamouring
clap	clapping	clapped	claps
clapboard	clapboards	clapboarded	clapboarding
clarify	clarification	clarified	clarifies	clarifying	clarity
clash	clashes	clashed	clashing
clasp	clasps	clasped	clasping	unclasp	unclasps	unclasped	unclasping
class	classed	classes	classing	classless	classlessness	classy	classier	classiest	classiness	subclass	subclasses
classify	classifying	classified	classifies	unclassified	classification	classifications	classificatory
clay	clays
clean	cleaned	cleaner	cleaners	cleanest	cleaning	cleanly	cleans	cleanness	cleanliness	unclean	uncleanliness
cleanse	cleanses	cleansed	cleansing	cleansings	cleanser	cleansers
clear	cleared	clearer	clearest	clearing	clearings	clearly	clearness	clears	unclear	clearance	clearances
clench	clenches	clenched	unclenched	clenching
clerk	clerks	clerkish
click	clicks	clicked	clicking	clicker	clickers
client	clients	clientele	clienteles
climax	climaxes	climaxed	climaxing	anticlimax	anticlimaxes
climb	climbs	climbing	climbers	climber	climbed	unclimbed
clinch	clinches	clinched	clinching	clincher	clinchers
cling	clinging	clings	clung
clip	clipping	clippings	clipped	clips	clipper	clippers
cloak	cloaked	cloaks
clock	clocks	clocked	clocking	clocker	clockers	oclock
closely	closeness	closer	closest
cloth	cloths
clothe	clothes	clothed	clothing	unclothe	unclothes	unclothed	unclothing	clothier	clothiers
cloud	cloudy	clouded	unclouded	clouds	clouding	cloudless
club	clubbed	clubbing	clubs
clump	clumps	clumped	clumping	clumpy	clumpier	clumpiest
clumsy	clumsier	clumsiest	clumsiness	clumsily
cluster	clustered	clustering	clusters
clutch	clutches	clutched	clutching
clutter	clutters	cluttered	cluttering	uncluttered
coach	coached	coaching	coaches
coast	coasts	coastal
coasted	coasting
coat	coats	coated	coating	coatings
coax	coaxes	coaxed	coaxing	coaxer	coaxers
cobweb	cobwebs
cock	cocks	cocked	cocking	cocky	cockier	cockiest	cockiness	cockily
code	coded	uncoded	codes	coding
cog	cogs
coherent	coherently	incoherent	incoherently	coherence	incoherence
coin	coins	coined	coining	coinage	coinages
cold	colder	coldest	coldly	coldness	colds	coldish
collaborate	collaborated	collaborating	collaborates	collaboration	collaborations	collaborationist	collaborationists	collaborative	collaboratively	collaborator	collaborators
collapse	collapsed	collapses	collapsible	collapsing
collar	collars	collarless
collect	collects	collecting	collected	uncollected	collective	collectively	collector	collectors	collection	collections	collectable	collectables	collectivist	collectivists	collectivism	collectivity
colour	color	colored	colorful	colorfully	coloring	colorless	colors	coloured	colourful	colourfully	colouring	colourless	colours	coloration	colouration
colt	colts	coltish
column	columns	col	cols	columnar
combat	combats	combated	combating	combatant	combatants	combative	combativeness
combine	combining	combines	combined	combination	combinations	recombine	recombined	recombines	recombining	recombination	recombinant
come	came	comes	coming	comings	comer	comers
comedy	comedies
comfort	uncomfortable	uncomfortably	discomfort	comforts	comforting	comforted	comfortably	comfortable	comfortingly
comic	comics	comical	comically	comicality	comicalities
command	commanded	commanding	commands	commander	commanders	commandment	commandments
commence	commenced	commences	commencement	commencing	recommences	recommenced	recommencing	recommence	recommencement	recommencements
commend	commends	commended	commending	commendable	commendation	commendatory
comment	commentaries	commentary	commented	commenting	comments	commentator	commentators
commerce	commercial	commercials	commercially	commercialisation	commercialise	commercialised	commercialising	commercialises	commercialize	commercialized	commercializing	commercializes	commercialization	commercialism
commiserate	commiserates	commiserated	commiserating	commiseration	commiserations
commit	commitment	commitments	commits	committed	uncommitted
common	commoner	commoners	commonest	commonly	commonness	commons	uncommon	uncommonly
community	communities
companion	companions	companionship	companionable
company	companies	co
compare	comparable	comparably	comparability	incomparable	compared	compares	comparative	comparison	comparisons	comparing	comparatively
compassion	compassions
compassionate	compassionately
compel	compelled	compelling	compels
compile	compilation	compilations	compiled	compiles	compiling	compiler	compilers	complies	complying	compliant
complacent	complacently
complain	complains	complaining	complained
complaints	complaint	complainant	complainants
complete	completed	uncompleted	completely	completion	completions	completes	completeness	completing	incomplete	incompletely
compliance	compliances
complicate	complicated	complicates	complication	complications	complicating	uncomplicated
comply	complied
compose	composing	composes	composer	composers	composed	composite	composition	compositions	compositional
comprehend	comprehends	comprehended	comprehending	noncomprehending	uncomprehending	uncomprehendingly	comprehension	comprehensions
comprehensive	comprehensively	comprehensiveness	comp	comps
compress	compresses	compressed	compressing	compression	compressions	compressor	compressors
compromise	compromised	compromises	compromising	uncompromising	uncompromisingly
compute	computation	computational	computationally	computations	computable	computer	computed	computerize	computerise	computerising	computerizing	computerises	computerizes	computerised	computerized	computerisation	computerization	computers	computing
conceal	concealed	unconcealed	concealing	concealment	conceals
conceive	conceivable	conceivably	conceived	conceives	conceiving	inconceivable	inconceivably
concept	conception	conceptions	concepts	conceptual	conceptualisation	conceptualisations	conceptualise	conceptualised	conceptualises	conceptualising	conceptualization	conceptualizations	conceptualize	conceptualized	conceptualizes	conceptualizing	conceptually
concern	concerned	concerning	concerns	unconcerned
conciliate	conciliates	conciliated	conciliating	conciliator	conciliators	conciliatory	conciliation
conclave	conclaves
conclude	concluded	unconcluded	concludes	concluding	conclusion	conclusions	conclusive	conclusively	inconclusive	inconclusively
condemn	condemnation	condemned	condemning	condemns
condition	conditional	conditionally	unconditionally	conditions	unconditional	conditioned	conditioning	conditioner	conditioners	unconditioned	conditionings
confer	conference	conferences	conferencing	conferred	conferring	confers
confess	confessing	confesses	confessed	confession	confessions	confessor	confessors	confessional
confide	confides	confided	confiding	confider	confiders	confidant	confidants
confidence	confidences	confident	confidently
confine	confined	confines	confining	unconfined	confinement	confinements
confirm	confirmation	confirmed	unconfirmed	confirming	confirms
conform	conforms	conformed	conforming	nonconforming	conformer	conformers	conformable	unconformable	conformation	conformance	conformances	conformist	conformists	nonconformist	nonconformists	conformity	conformities	nonconformity
confound	confounds	confounded	confounding
confuse	confusing	confusingly	confuses	confused	confusion
congratulate	congratulates	congratulated	congratulating	congratulatory	congratulation	congratulations
conjecture	conjectures	conjecturing	conjectured	conjectural
conjure	conjures	conjured	conjuring	conjurer	conjurers	conjuration
connect	connected	connecting	connects	connection	connections	connexion	connexions	unconnected	connector	connectors	interconnect	interconnected	interconnects	interconnecting	interconnection	interconnections	connective	connectives	connectivity
conquest	conquests
conscience	consciences
conscientious	conscientiousness	conscientiously
conscious	consciousness	unconsciousness	unconscious	unconsciously	consciously
consequential	consequentially	inconsequential	inconsequentially
consider	consideration	considerations	considered	unconsidered	considering	considers	reconsider	reconsiders	reconsidered	reconsidering	reconsideration	reconsiderations
considerable	inconsiderable	considerably
consist	consisted	consisting	consists
consistent	consistently	consistency	consistencies	inconsistency	inconsistencies	inconsistent
constant	constantly	constants	inconstantly	constancy	inconstancy	constancies	inconstancies
construct	constructed	constructing	construction	constructions	constructive	constructively	constructs	constructor	constructors	constructional	constructivist	constructivists	reconstruct	reconstructed	reconstructing	reconstruction	reconstructs
consume	consumed	consumer	consumers	consumes	consuming	consumption	consumerism	consumable	consumables
contact	contactable	uncontactable	contacted	contacting	contacts
contagious	contagiousness	contagiously	noncontagious
contain	contained	container	containers	containing	contains	containment
contemplate	contemplated	contemplates	contemplating	contemplation	contemplative
contempt	contempts	contemptuous	contemptuousness	contemptuously	contemptible
content	contented	contenting	contentment	contents	contentedly
contest	contests	contested	contesting	contestable	incontestable	contestant	contestants
contingency	contingencies
continue	continual	continually	continuance	continued	continuity	continues	continuing	continuous	continuously	continuation	continuations
contort	contorts	contorted	contorting	contortion	contortions
contract	contracted	contracting	contractor	contractors	contracts
contradict	contradicted	contradicting	contradiction	contradictions	contradictory	contradicts
contrast	contrasted	contrasting	contrastive	contrasts
contribute	contributed	contributes	contributing	contribution	contributions	contributor	contributors	contributory	noncontributory
contrite	contriteness	contritely
control	controlled	controller	controllers	controlling	controls	uncontrollable	uncontrollably	controllable	uncontrolled
controversy	controversies	controversial	controversially	uncontroversial
controvert	controverts	controverted	controverting	controvertible	incontrovertible
convene	convenes	convened	convening	convener	conveners
convenience	conveniences	convenient	conveniently	inconvenient
converse	converses	conversed	conversing	conversant	conversation	conversations	conversational	conversationally	conversationalist	conversationalists	conversely
convert	converted	unconverted	convertible	convertibility	converting	converts	converter	converters	conversion	conversions
convey	conveyance	conveyed	conveyer	conveyers	conveying	conveys	conveyor	conveyors	conveyancing	conveyancings
convict	convicted	convicting	convicts	conviction	convictions	unconvicted
convince	convinced	convinces	convincing	convincingly	unconvincing	unconvincingly	unconvinced
convulse	convulsed	convulses	convulsing	convulsion	convulsions	convulsive	convulsively
cook	cooks	cooking	cookers	cooker	cooked	uncooked	cookery	cookeries
cool	cools	coolness	coolly	cooling	coolest	cooler	coolers	cooled	uncooled	coolant	coolants
copy	copying	copies	copied	copier	copiers	copyist	copyists
copyright	copyrighted	copyrights
cord	cords	cordless
cordial	cordially	cordiality	cordialities
corner	corners	cornered	cornering
coroner	coroners
corporate	corporates	corporation	corporations	corp	corporatism	corporatist	corporatists
correct	corrects	correctly	correcting	corrected	correctness	correction	corrections	corrective	incorrect	incorrectly	uncorrected
corroborate	corroborates	corroborated	corroborating	corroboratory	corroboration	corroborations
corrupt	corrupted	corrupting	corrupts	corruption	corrupter	corrupters	corruptest	corruptness	corruptly
cost	costing	costings	costed	costs	costly	costless
costume	costumes
cottage	cottages	cottager	cottagers	cottaged
couch	couches	couched	couching
cough	coughs	coughed	coughing
could	couldn
count	counted	uncounted	counting	countless	counts	countable	uncountable
countenance	countenances	countenanced	countenancing
counter	countered	counters	countering
country	countries
county	counties
couple	coupled	uncoupled	coupling	couples
courage	courageous	courageously
course	courses
courtship	courtships
cover	covered	covering	coverings	coverage	covers	uncover	uncovered	uncovers	coverlet	coverlets
covert	covertness	covertly
covet	coveting	covets	coveted
cow	cows
coward	cowards	cowardly	cowardliness	cowardice	cowardices
cowboy	cowboys
cower	cowers	cowered	cowering
coy	coyly
crack	cracks	cracking	cracked
cradle	cradled	cradling	cradles
craft	crafts	crafty	craftiness	craftier	craftiest	craftily	crafted	crafting
cramp	cramped	cramps	cramping
crash	crashing	crashes	crashed
crawl	crawled	crawling	crawls
crazy	crazier	craziest	crazily	craziness
creak	creaked	creaks	creaky	creaking
cream	creams	creaming	creamed	creamy	creamier	creamiest	creaminess	creamily
crease	creased	uncreased	creasing	creases
create	created	creates	creating	creation	creations	creative	creatively	creativity	creator	creators	recreate	recreated	recreates	recreating
creature	creatures
credence	credences
credit	credited	crediting	creditor	creditors	credits
creep	crept	creeps	creeping	creepy	creeper	creepers
crest	crested	cresting	crests	crestless
crevice	crevices
crick	cricks	cricked	cricking
crimson
cringe	cringes	cringed	cringing
crisis	crises
crisp	crisped	crisping	crisps	crispy	crispier	crispiest	crispiness	crisply
critic	critics	critically	critical	uncritical	uncritically
criticise	criticised	criticises	criticising	criticize	criticizes	criticized	criticizing	criticizer	criticizers
croak	croaks	croaked	croaking
crockery	crockeries
crook	crooked	crookedness	crookedly	crooks	crookeder	crookedest
croon	croons	crooned	crooning	crooner	crooners
crop	crops	cropping	cropped	cropper	croppers
cross	crossed	crosses	crossing	crossings	crossly	crossness
crossroads	crossroad
crouch	crouches	crouched	crouching
crowd	crowded	uncrowded	crowding	crowds
crown	crowns	crowned	crowning	uncrowned
cruel	cruelly	cruelness	cruellest	crueller	cruelty	cruelties
crush	crushing	crushes	crushed
cry	cried	cries	crying	crier	criers
cryptic	cryptically
crystal	crystals	crystallise	crystallised	crystallising	crystallises	crystallize	crystallized	crystallizes	crystallizing	crystallization	crystallisation
cuddle	cuddles	cuddled	cuddling	cuddly
cue	cued	cuing	cues
cunning	cunninger	cunningest	cunningly
cup	cups	cupping	cupped	cuplike
cure	curing	cures	cured	curable	incurable	curative
curious	curiously	curiosity
curl	curls	curly	curlier	curliest	curliness	curled	curling	curler	curlers	uncurl	uncurls	uncurled	uncurling
current	currents	currently
curse	curses	cursed	cursing
curtain	curtains	curtained	curtaining
curve	curving	curves	curved	curvature	curvatures
cushion	cushioned	cushioning	cushions
custodian	custodians	custodianship	custodianships
custom	customs	customary	customarily
cut	cuts	cutting	cuttings	uncut	cutter	cutters
d
dab	dabbed	dabbing	dabs	dabber	dabbers
dabble	dabbles	dabbled	dabbling	dabbler	dabblers
dad	daddy	dads
dam	dammed	damming	dams
damage	damaging	damages	damaged	undamaged
damn	damned	damning	damns	damnable	damnedest	damnation	dammit	damnit
damp	dampness	dampest	damper	dampen	dampens	dampened	dampening	dampener	dampeners	damping	damps	damped
dance	danced	dancer	dancers	dances	dancing
danger	dangerous	dangerously	dangers	endanger	endangers	endangered	endangering	endangerment	endangerments
dangle	dangles	dangled	dangling	dangler	danglers
dare	dared	dares	daring
dark	darker	darkest	darkness	darken	darkens	darkened	darkening	darkener	darkeners	darkly
darn	darned	darning	darns
dart	darts	darted	darting
dash	dashes	dashed	dashing	dasher	dashers
dastardly	dastardliness
data	datum
date	dates	dated	undated	dating	datable
dawn	dawned	dawning	dawns
day	daily	daylight	days	midday	goodday	gidday
daze	dazes	dazing	dazed	dazedly
dazzle	dazzles	dazzled	dazzling	dazzler	dazzlers	dazzlingly
dead	deaden	deadened	deadening	deadens	deadly
deaf	deafer	deafest	deafness	deafen	deafens	deafened	deafening	deafeningly
deal	dealer	dealers	dealership	dealerships	dealing	dealings	deals	dealt	undealt
dear	dearer	dearest	dearly	dears
dearth	dearths
death	deathly	deaths	deathless	deathlessly
debate	debatable	debated	debates	debating
debt	debts	debtor	debtors
deceit	deceits	deceitful	deceitfulness	deceitfully
deceive	deceives	deceived	deceiving	deceiver	deceivers	undeceive	undeceives	undeceived	undeceiving
deception	deceptions	deceptive	deceptiveness	deceptively
decide	decided	decidedly	decides	deciding	undecided	decider	deciders
decipher	deciphers	deciphered	deciphering	decipherable	undecipherable	indecipherable
decision	decisions
decisive	decisively	indecisive	indecisively	indecisiveness
declare	declaration	declarations	declared	undeclared	declares	declaring
decorate	decoration	decorations	decorated	undecorated	decorates	decorating	decorative	decoratively	decorator	decorators	redecorate	redecorates	redecorated	redecorating	redecoration	redecorations
deduct	deducted	deducting	deducts	deduction	deductions	deductible	deductibility	deductive	deductively
deep	deepen	deepens	deepened	deeper	deepest	deeply	depth	depths	deepening
defect	defects	defective	defectiveness	defectively
defected	defecting	defection	defections	defectors	defector	defecter	defecters
defence	defences	defense	defenses	defensive	defensively	defenceless	defencelessly	defensible	indefensible	indefensibly	defensibly
defer	deferring	deferred	defers	deferment	deferments	deference	deferences	deferential	deferentially
defiance	defiances
defiant	defiantly
define	definable	indefinable	indefinably	undefinable	defined	defines	defining	definition	definitions	definitional	redefine	redefined	redefines	redefining	redefinition	redefinitions	undefined
definite	definitely	definitive	definitively	indefinite	indefinitely
deft	defter	deftest	deftness	deftly
degree	degrees	deg
deject	dejecting	dejects	dejected	dejectedly	dejection
delay	delays	delaying	delayed
delete	deletes	deleted	deleting	deletion	deletions
deliberate	deliberately
deliberated	deliberates	deliberating	deliberation	deliberations
delicate	delicately	delicacy	delicacies
delicious	deliciousness	deliciously
delight	delights	delighting	delightfully	delightful	delighted	delightedly
delinquent	delinquents	delinquently	delinquency	delinquencies
deliver	delivered	deliveries	delivering	delivers	undelivered	delivery
demagogue	demagogy	demagoguery
demand	demanded	demanding	demands	undemanding
demonstrate	demonstrable	demonstrably	demonstrated	demonstrates	demonstrating	demonstration	demonstrations	demonstrative	demonstratively	demonstrator	demonstrators	demo	demos
den	dens
deny	deniable	denial	denials	denied	denies	denying	undeniable	undeniably
depart	departs	departed	departing
departure	departures
depend	depends	depended	depending	dependant	dependants	dependent	dependents	dependable	undependable	dependably	dependence	dependences	interdependence	interdependences	dependency	dependencies
deprecate	deprecates	deprecateed	deprecating	deprecatingly	deprecation
depress	depressed	depresses	depressing	depression	depressions	depressive	depressives	depressingly	antidepressant	antidepressants
deride	derides	derided	deriding	derision	derisions	derisive	derisively	derisory
derive	derivation	derivations	derivative	derivatives	derived	derives	deriving
derogatory	derogatorily
descent	descents
describe	described	describes	indescribable	indescribably	describing	description	descriptions	descriptive
desert	deserted	deserting	deserts	deserter	deserters	desertion	desertions
deserve	deserving	deserves	deservedly	deserved	undeserved
design	designed	designer	designers	designing	designs
desire	desired	desirability	desirable	desires	desiring	undesirable	desirous
desk	desks
desolate	desolated	desolateness	desolately	desolation
despair	despairs	despairingly	despairing	despaired
despatch	despatched	despatching	despatches	despatcher	despatchers	dispatch	dispatches	dispatched	dispatching	dispatcher	dispatchers
desperate	desperation	desperately
despise	despises	despised	despising
despite
despot	despots	despotism
destroy	destroyed	destroying	destroys	destruction	destructive	destroyer	destroyers
desultory	desultorily
detach	detaches	detached	detaching	detachable	nondetachable	detachment	detachments
detail	detailed	detailing	details
detain	detains	detained	detaining	detainment	detainments	detainee	detainees
determine	determination	determinations	determined	undetermined	determinedly	indeterminate	determinate	determines	determining	determinant	determinants	determinism	determinist	determinists	deterministic	deterministically	indeterminacy	indeterminacies
detour	detoured	detouring	detours
deuce	deuces
develop	developed	developer	developers	developing	development	developments	developmental	developmentally	develops	underdeveloped	underdevelopment	undeveloped	redevelop	redevelops	redeveloped	redeveloping	redevelopment	redevelopments
devote	devoted	devotedly	devotes	devoting	devotion	devotions	devotional	devotee	devotees
devour	devours	devoured	devouring
dial	dials	dialed	dialing	dialled	dialling
die	died	dies	dying	undying
difference	differences	different	differently
difficult	difficulties	difficulty
diffident	diffidently	diffidence
dig	digger	diggers	digging	digs	dug	undug
dignify	dignifies	dignifying	dignified	undignified
dignity	dignities
dilapidated
dilate	dilates	dilated	dilating	dilation
dim	dimmed	dimming	dims	dimness	dimly	dimmer	dimmest
dimension	dimensional	dimensions
din	dins
dingy	dingier	dingiest	dinginess	dingily
dinner	dinners
diplomat	diplomatic	diplomatically	diplomats
direct	directed	undirected	directing	directly	director	directors	directorship	directorships	directs	indirect	indirectly	directness	directnesses
direction	directional	directions
dirty	dirtier	dirtiest	dirt
disappear	disappearance	disappearances	disappeared	disappearing	disappears
disappoint	disappoints	disappointing	disappointingly	disappointed	disappointment	disappointments
disapprove	disapproving	disapprovingly	disapproves	disapproved	disapproval
disarm	disarms	disarmed	disarming	disarmament	disarmingly
disaster	disasters	disastrous	disastrously
disc	discs	disk	disks	diskette	diskettes	discette	discettes
discern	discerns	discerned	discerning	discernment	discernments
discipline	disciplined	undisciplined	disciplining	disciplines	disciplinary	disciplinarian	interdisciplinary	indiscipline
disclaim	disclaims	disclaimed	disclaiming	disclaimer	disclaimers
disclose	discloses	disclosed	undisclosed	disclosing
disclosure	disclosures
discolour	discolours	discolouring	discoloured	discolouration	discolourations	discolor	discoloring	discolors	discolored	discoloration	discolorations
disconcert	disconcerted	disconcerts	disconcerting	disconcertingly
discontinue	discontinues	discontinued	discontinuing	discontinuation	discontinuance	discontinuances
discord	discords	discordant
discourage	discouraged	discourages	discouraging	discouragement
discourse	discourses
discover	discovered	discoveries	discovering	discovers	discovery	discoverer	discoverers	undiscovered	rediscover	rediscovers	rediscovered	rediscovering	rediscovery	rediscoveries
discrepancy	discrepancies
discuss	discussing	discusses	discussed	undiscussed	discussion	discussions
disdain	disdained	disdaining	disdains	disdainful	disdainfully
disengage	disengages	disengaged	disengaging	disengagement	disengagements
disguise	disguises	disguised	undisguised	disguising
disgust	disgusted	disgusts	disgusting	disgustingly
disillusion	disillusions	disillusioned	disillusioning	disillusionment	disillusionments
disinterested	disinterestedness	disinterestedly
dislodge	dislodges	dislodged	dislodging	dislodgment
disloyal	disloyally	disloyalty	disloyalties
dismantle	dismantles	dismantled	dismantling	dismantlement	dismantlements
dismay	dismayed	dismays	dismaying
disorder	disorders	disordered	disorderly
dispel	dispelling	dispelled	dispels
display	displayed	displaying	displays	undisplayed
dispose	disposable	disposal	disposed	disposes	disposing
dispute	disputed	undisputed	disputing	disputes
disrupt	disrupts	disrupted	disrupting	disruption	disruptions
dissolution	dissolutions
dissolve	dissolved	dissolves	dissolving
distance	distances	distant	distantly	distanced	distancing
distinct	distinction	distinctions	distinctive	distinctively	distinctly	indistinct	indistinctly	distinctiveness	distinctivenesses
distinguish	distinguished	undistinguished	distinguishes	distinguishing	distinguishable	indistinguishable
distort	distorts	distorted	undistorted	distorting	distortion	distortions
distribute	distributes	distributed	distributing	distribution	distributional	distributions	distributive	distributor	distributors	distributable	redistribute	redistributed	redistributes	redistributing	redistribution	redistributive
district	districts
distrust	distrusted	distrusting	distrusts	distrustful	distrustfully
disturb	disturbs	disturbing	disturbed	undisturbed	disturbance	disturbances	disturbingly
ditch	ditches	ditched	ditching
dive	diving	dives	dived	dove	diver	divers
dizzy	dizzier	dizziest	dizziness	dizzily	dizzied	dizzies	dizzying
do	did	didn	does	doesn	doing	doings	don	done	doer	doers
doctor	doctors	dr	doc	docs	doctoral
dodge	dodges	dodged	dodging	dodger	dodgers
dog	dogs	doggy	doggies
dogged	doggedly
doleful	dolefulness	dolefully
dollar	dollars
domain	domains
dominate	dominated	dominates	dominating	domination	dominant	dominance
domino	dominoes
donate	donated	donates	donating	donation	donations
donor	donors
door	doors	indoors	indoor	outdoors	outdoor
doorway	doorways
dot	dotted	dotting	dots
double	doubled	doubles	doubling	doubly	redoubled	redoubles	redoubling	redouble
doubt	doubted	doubtful	doubtfully	doubter	doubters	doubting	doubtless	undoubted	undoubtedly	doubts
down	downs	downed	downing	downings	downward	downwards
download	downloads	downloaded	downloading
downpour	downpours
downright
dozen	dozens
drab	drabness	drably
draft	drafted	drafting	drafts	redraft	redrafts	redrafted	redrafting
drag	drags	dragging	dragged
drain	drained	draining	drains
drama	dramas	dramatic	dramatically	dramatise	dramatised	dramatising	dramatises	dramatisation	dramatisations	dramatist	dramatists	dramatization	dramatizations	dramatize	dramatized	dramatizes	dramatizing
drape	drapes	draped	draping	draper	drapers	drapery	draperies
draw	drawing	drawings	drawn	undrawn	draws	drew	redraw	redraws	redrawing	redrew	redrawn
drawer	drawers
drawl	drawls	drawled	drawling
dread	dreads	dreaded	dreading
dreadful	dreadfully
dream	dreamed	undreamed	dreamer	dreamers	dreaming	dreams	dreamt	dreamy	dreamily
dreary	drearier	dreariest	dreariness	drearily
drench	drenches	drenched	drenching
dress	dressed	dresses	dressing	undressed	undress	undresses	undressing
drift	drifted	drifting	drifts	drifter	drifters
drink	drinks	drinker	drinkers	drank	drunk	undrunk	drinking
drip	dripping	dripped	drips
drive	driven	undriven	driver	drivers	drives	driveway	driving	drove
drone	droned	droning	drones
droop	droops	drooped	drooping	droopy	drowsily
drop	dropped	dropping	droppings	drops	droplet	droplets
drown	drowns	drowning	drowned
drowsy	drowsier	drowsiest	drowsiness
drum	drums	drumming	drummed	drummer	drummers
drunken	drunkenness	drunkenly
dry	dried	dries	driest	dryer	drying	dryly	drily	dryness	drier	driers
dryad	dryads
dub	dubbing	dubbed	dubs	dubber
dubious	dubiousness	dubiously
duck	ducks	ducking	ducked	duckling	ducklings
due	duly	undue	unduly	dues
dull	dullness	dullest	duller	dully	dulled	dulls	dulling
dumb	dumber	dumbest	dumbness	dumbly
duplicate	duplicates	duplicated	duplicating	duplication	reduplication
during
dusk	dusks	dusky	duskier	duskiest	duskiness
dust	dusts	dustless	dusty	dustier	dustiest	dustiness	dusted	dusting	duster	dusters
duty	duties	dutiful	dutifully	dutifulness
dwell	dwells	dwelt	dwelled	dweller	dwellers	dwelling	dwellings
dyspeptic	dyspeptically	dyspepsia
e
each
eager	uneager	eagerness	eagerly
ear	ears
early	earlier	earliest	earliness
earn	earns	earning	earned	unearned	earnings	earner	earners
earnest	earnestness	earnestly
earth	earths	earthy	earthly	unearthly	unearthliness
ease	easing	eases	eased	unease	uneasily	uneasy	uneasiness
east	eastward	eastwards	easterly	easterlies	eastern	easterner	easterners
easy	easier	easiest	easily	easiness
eat	ate	eaten	uneaten	eating	eats	eater	eaters
eave	eaves
ebb	ebbs	ebbing	ebbed
echo	echoed	echoes	echoing
ecstasy	ecstasies
ecstatic	ecstatically
edge	edged	edges	edging
edify	edifies	edified	edifying	edification
edit	edited	unedited	editing	edition	editions	editor	editorial	editorials	editors	edits	ed	eds	editorship	editorships
educate	educating	educates	educated	educative	miseducated	educator	educators	uneducated	education	educationist	educationists	educational	educationally	educationalist	educationalists
efface	effaces	effaced	effacing	effacement	effacable	effacer
effect	effected	effecting	effective	effectively	effectiveness	effects	ineffective	ineffectively	ineffectiveness	ineffectivenesses	effector	effectors
effort	efforts	effortless	effortlessly
egg	eggs	egged	egging
eight	eighteen	eighteenth	eighth	eighths	eighties	eightieth	eighty	eights
either
ejaculate	ejaculated	ejaculates	ejaculating	ejaculation	ejaculations
eke	ekes	ekeed	eking
elaborate	elaborately	elaborateness	elaborated	unelaborated	elaborates	elaboration	elaborations
elapse	elapses	elapsed	elapsing
elate	elated	elatedly	elating	elates	elation	elations
elbow	elbows
elect	elected	unelected	electing	election	elections	elects	elector	electors	electoral	electorally
electric	electricity	electricians	electrician	electrical	electrically	electrics
electronic	electronics	electronically
element	elements
eleven	elevens	eleventh
elf	elves	elfish	elven	elvish	elflike
elite	elites	elitist	elitists	elitism
eloquent	eloquently	eloquence	eloquences
else	elsewhere
embarrass	embarrassed	embarrasses	embarrassing	embarrassingly	embarrassment
embitter	embittering	embitters	embittered	embitterment
embrace	embraced	embraces	embracing
emigrant	emigrants
eminence	eminences
eminent	eminently
emotion	emotional	emotionally	unemotionally	unemotional	emotions
emphasis	emphases	emphasise	emphasises	emphasised	unemphasised	emphasising	emphasize	emphasized	unemphasized	emphasizes	emphasizing
emphatic	unemphatic	emphatically
employ	employed	employee	employees	employer	employers	employing	employment	employs	employable	unemployed	unemployable	unemployment
empty	emptying	empties	emptied	emptiness
enchant	enchants	enchanted	enchanting	enchanter	enchanters	enchantment	enchantments	enchantingly
encircle	encircles	encircled	encircling	encirclement	encirclements
encounter	encountered	unencountered	encountering	encounters
encourage	encouragingly	encouraging	encourages	encouraged	encouragement
end	ended	unended	ending	endings	endless	endlessly	ends	unending
endear	endears	endeared	endearing	endearment	endearments	endearingly
endeavour	endeavours	endeavoured	endeavouring	endeavor	endeavors	endeavored	endeavoring
endurance	endurances
endure	endured	endures	enduring	unendurable	endurable
engage	engaged	engaging	engagingly	engages	engagement	engagements
engine	engines	engineer	engineering	engineers	engineered
english	englishman	englishmen	englishwoman	englishwomen	englishes	england	englander	englanders	englishness
engross	engrosses	engrossed	engrossing	engrossment	engrossments
enigma	enigmas
enjoy	enjoyed	enjoying	enjoyment	enjoys	enjoyable	unenjoyable
enmity	enmities
enormity	enormities
enough
ensure	ensured	ensures	ensuring
enter	entered	unentered	entering	enters	entrance	entrances	entries	entry
entertain	entertains	entertaining	unentertaining	entertained	entertainment	entertainments	entertainer	entertainers
enthusiasm	enthusiasms	enthusiast	enthusiasts	enthusiastic	enthusiastically	unenthusiastic	unenthusiastically	enthuse	enthuse	enthuses	enthused	enthusing
entice	entices	enticed	enticing	enticement	enticements
entire	entirity	entirely	entirety	entireties
entity	entities
entrench	entrenches	entrenched	entrenching	entrenchment	entrenchments
enunciate	enunciates	enunciated	enunciating	enunciation
envelope	enveloped	enveloping	envelopes	envelop	envelops	enveloper	envelopers	envelopment	envelopments
envy	envies	envied	envying	enviable	unenviable	enviably	envious	enviousness	enviously
epic	epics	epically
equal	equaled	equaling	equality	equalled	equalling	equally	equals	inequality	inequalities	unequal	unequalled	equalise	equalised	equalises	equalisation	equalize	equalized	equalizes	equalization	equaliser	equalisers	equalizer	equalizers
equip	equipment	equipped	unequipped	equipping	equips
equipage
erect	erected	erecting	erection	erections	erects
errand	errands
erratic	erratically
error	errors
especial	especially
establish	disestablish	disestablished	disestablishes	disestablishing	disestablishment	established	establishes	establishing	establishment	establishments	reestablish	reestablishing	reestablished	reestablishes	reestablishment
estimate	estimated	est	estimates	estimating	estimation	estimations	estimator	estimators	inestimable	inestimably
etch	etches	etched	etching	etcher	etchers
evasion	evasions
eve	eves
even	evenly	uneven	unevenly
evening	evenings
event	eventful	events	uneventful	uneventfully
eventual	eventuality	eventualities	eventually
ever
everlasting	everlastingly
every	everybody	everyday	everyone	everything	everywhere
evidence	evidenced	evidential
evident	evidently
evolve	evolution	evolved	evolving	evolves	evolutionary	evolutionist	evolutionists
ex
exact	exactly	exactness
exaggerate	exaggerates	exaggerated	exaggerating	exaggeration	exaggerations
examine	examining	examines	examined	unexamined	examiner	examiners	examination	examinations	exam	exam
exasperate	exasperated	exasperates	exasperating	exasperation	exasperations
exceed	exceeded	exceeding	exceedingly	exceeds
excellent	excellence	excellently
except	exception	exceptional	exceptionally	exceptions	excepting
excess	excesses	excessive	excessively
excite	exciting	excites	excitedly	excited	excitement	excitable	excitably	excitation	excitations
exclaim	exclaims	exclaimed	exclaiming	exclamation	exclamations	exclamatory
exclude	excluded	excludes	excluding	exclusion	exclusionary	exclusionist	exclusions	exclusive	exclusively	exclusivity
excursion	excursions	excursionist	excursionists
excuse	excusing	excuses	excused	excusable	inexcusable
execute	executed	executes	executing	execution	executions	executioner	executioners
executive	executives
exempt	exemption	exemptions	nonexempt	exempted	exempts	exempting
exercise	exercised	exercises	exercising	exercisable
exhaustive	exhaustiveness	exhaustively
exhibit	exhibited	exhibiting	exhibition	exhibitions	exhibits	exhibitor	exhibitors	exhibitionism
exist	existed	existence	existing	exists	existent	nonexistent
exit	exits	exited	exiting
expanse	expanses	expansive	expansiveness	expansively
expect	expectancy	expectation	expectations	expected	expectedly	expecting	expects	unexpected	unexpectedly	expectant	expectantly
expend	expends	expended	expending	expendable
expense	expenses	expensive	expensively	inexpensive	inexpensiveness	inexpensively	expenditure	expenditures
experiment	experimental	experimentally	experimentation	experimented	experimenting	experiments	experimenter	experimenters
explain	explained	unexplained	explaining	explains	explanation	explanatory	explanations
explode	explodes	exploded	exploding
exploit	exploits	exploited	exploiting	exploiter	exploiters	exploitable	exploitation	exploitations	exploitative
explosion	explosions	explosive	explosives	explosiveness	explosively	nonexplosive
export	exports	exporting	exported	exporter	exporters
expose	exposed	unexposed	exposes	exposing	exposure	exposures
express	expressed	unexpressed	expresses	expressing	expression	expressions	expressionless	expressionlessly	expressive	expressively	expressiveness	expressly
extend	extended	unextended	extending	extends	extension	extensions	extensive	extensively	extent
extenuate	extenuates	extenuated	extenuating	extenuation
exterior	exteriors
extinguish	extinguishes	extinguished	extinguishing	extinguisher	extinguishers	extinguishable	inextinguishable	
extra	extras
extraordinary	extraordinarily
extreme	extremely	extremes	extremity	extremities	extremist	extremists	extremism
exult	exults	exulted	exulting	exultation	exultant	exultantly	exultations
eye	eyes	eyed	eyeing	eyeful
eyelid	eyelids
eyesore	eyesores
f
fabric	fabrics
fabulous	fabulously	fab
face	faced	faces	facing	faceless	facial	facially
facetious	facetiousness	facetiously
facility	facilities
fact	facts	factual	factually
faction	factions	factional	factionalism
fade	fading	unfading	fades	faded	unfaded
fail	failed	failing	failings	fails	unfailing	unfailingly	failure	failures
faint	faints	faintly	fainting	fainter	faintest	fainted	faintness
fair	fairer	fairest	fairly	fairness	unfairness	unfair	unfairly
faith	faithful	faithfulness	faithfully	faiths	unfaithful	unfaithfulness	unfaithfully	faithless	faithlessly
fake	fakes	faked	faking
fall	fallen	falling	falls	fell
fallible	fallibleness	fallibly	fallibility	fallibilities	infallible	infallibly	infallibility
falsetto	falsettos
falter	falters	faltered	faltering
fame	famed	famous	famous	famously
familiar	familiarly	familiarity	unfamiliar	unfamiliarity	familiarise	familiarises	familiarised	familiarising	familiarisation	familiarize	familiarizes	familiarized	familiarizing	familiarization
family	families	familial
fancy	fancied	fancier	fancies	fanciest	fancily	fanciness	fancying	fanciful	fancifulness	fancifully
fantastic	fantastically
far	farther	farthest	faraway
farce	farces	farcical
farewell	farewells
farm	farmer	farmers	farms	farming	farmed	unfarmed
farmhouse	farmhouses
fascinate	fascinated	fascinates	fascinating	fascination
fashion	fashionable	fashionably	fashioned	fashioning	fashions	unfashionable	unfashionably
fast	faster	fastest
fasten	fastens	fastened	fastening	fastener	fasteners	unfasten	unfastens	unfastened	unfastening
fastidious	fastidiousness	fastidiously
fat	fatter	fattest	fatness	fatty	fattier	fattiest	fattiness	fatten	fattening	fattened	fattens	fattish	fats
father	fathers	fatherly	fatherhood
fathom	fathoms	fathomed	fathoming	fathomable	unfathomable	unfathomably
fatigue	fatigued	fatiguing	fatigues
fault	faulty	faults	faultless	faulted	unfaulted
favour	favor	favors	favorite	favorites	favourite	favourable	favourably	favoured	unfavoured	favorable	favorably	favored	unfavored	favouring	favoring	favourites	favours	unfavourable	unfavourably	favouritism	favoritism
fear	feared	unfeared	fearful	fearfully	fearless	fearlessly	fearlessness	fearing	fears
feast	feasts	feasted	feasting
feature	featured	features	featuring	featureless
federal	federally	federalism	federalist	federalists	federalize	federalizes	federalized	federalizing
fee	fees
feeble	feebleness	feebly
feed	fed	feeding	feeds	unfed	feeder	feeders
feel	feeling	feelings	unfeeling	feels	felt
fellow	fellows	fellowship	fellowships	fella	fellas
feminine	unfeminine	femininely	femininity	femininities
fence	fencing	fences	fenced	unfenced
fern	ferns	ferny	fernier	ferniest
ferocity	ferocities
fertile	infertile	fertility	infertility	fertilise	fertilize	fertilised	fertilized	fertilises	fertilizes	fertilizing	fertilising	fertiliser	fertilisers	fertilizer	fertilizers	fertilisation	fertilization
fervid	fervidly	fervidness
fetch	fetched	fetches	fetching
fever	fevers	fevered	feverish	feverishly
few	fewer	fewest
fibre	fibres	fiber	fibers	fibrous
fiction	fictional	nonfiction
fiddle	fiddles	fiddled	fiddling	fiddler	fiddlers
fidget	fidgets	fidgeted	fidgeting
field	fields	fielded	fielding	fielder	fielders	midfielder	midfielders
fierce	fiercest	fiercer	fierceness	fiercely
fight	fighter	fighters	fighting	fought	fights
figure	figures	figured	figuring	figurings	figural	fig	figs
file	filed	unfiled	files	filing
fill	filled	unfilled	filling	fillings	fills	filler	fillers	refill	refilled	refilling	refills	refillable
film	films	filming	filmed
filter	filtered	unfiltered	filtering	filters	filtrate	filtrated	filtrating	filtration	filtrations
final	finalise	finalised	finalist	finalists	semifinalist	semifinalists	finalises	finalising	finalize	finalized	finalizes	finalizing	finality	finally	finals
finance	financed	unfinanced	finances	financial	financially	financier	financiers	financing
find	finding	findings	finds	found	unfound	finder	finders
fine	finely	fineness	finer	finest	finery	fined	fines	fining	finings	unfined
finger	fingers	fingered	fingering
fingernail	fingernails
fingertip	fingertips
finish	finished	finishes	finishing	unfinished	finisher	finishers
fire	fires	fired	firing	misfire	misfires	misfired	misfiring
firm	firmness	firmly	firmer	firmest	firmed	firming	firms
first	firsts	firstly
fissure	fissured	fissuring	fissures
fist	fists	fisted	fistful
fit	fitness	fits	fitted	fitter	fittest	fitting	fittings	fittingly	unfit
five	fives	fifteen	fifteenth	fifth	fifths	fifthly	fifties	fiftieth	fifty
fix	fixed	unfixed	fixes	fixing	fixable	fixedly	fixer	fixers
flagrant	flagrantly
flame	flames	flaming	flamed
flank	flanks	flanked	flanking	flanker	flankers
flannel	flannels	flannelette	flannelettes	flannelling
flap	flapping	flapped	flaps
flare	flares	flared	flaring
flash	flashing	flashes	flashed
flat	flattest	flatten	flattens	flattened	flattening	flattish	flatness	flatly
flatter	flatters	flattered	flattering	flatterer	flatterers	flattery	unflattering	flatteringly
flaunt	flaunts	flaunted	flaunting
flaw	flawed	flaws	flawless	flawlessness	flawlessly
fleck	flecks	flecked	flecking
flee	fled	fleeing	flees
fleeting	fleetingness	fleetingly
flesh	fleshy	fleshiness
flexible	flexibility	inflexible	inflexibility	flexibly	inflexibly
flicker	flickers	flickered	flickering
flight	flights	flightless	flt	flighty
flinch	flinches	flinched	flinching
fling	flinging	flings	flung
flip	flipping	flipped	flips
flit	flitting	flitted	flits
float	floats	floating	floated
flock	flocks	flocked	flocking
flood	floods	flooding	flooded
floor	floors	flooring	floorings	floored
flop	flopping	flopped	flops
flounder	flounders	floundered	floundering
flourish	flourished	flourishes	flourishing
flow	flowed	flows	flowing
flower	flowered	flowering	flowers	flowery	flowerier	floweriest	floweriness
fluent	fluently
fluke	flukes	flukey
flurry	flurries
flush	flushes	flushed	flushing	flusher	flushers
fluster	flusters	flustered	flustering
flutter	flutters	fluttered	fluttering
fly	flew	flown	unflown	flying	flies	flyer	flyers	flier	fliers
fog	fogs	foggy	fogginess
fold	folds	folding	folded	unfold	unfolds	unfolded	unfolding
folk	folks
follow	followed	unfollowed	follower	followers	following	ff	follows
folly	follies
food	foods
fool	fools	foolishness	foolishly	foolish	fooling	fooled
foot	feet	footed	football	footballing	footballs	footballer	footballers	ft	footing	footings
footstep	footsteps
for	fer
forbid	forbids	forbade	forbidding	forbidden
force	forced	unforced	forcible	forcibly	forces	forcing	forceful	forcefully
fore	foremost
forefather	forefathers
forefinger	forefingers
forehead	foreheads
foresee	foreseeing	foresaw	foreseen	foresees	foreseer	foreseers	foreseeable	unforeseeable	unforeseen
forever
forget	forgets	forgetting	forgot	forgotten	unforgotten	unforgettable	forgetful	forgetfulness	forgetfully
forgive	forgiving	forgives	forgiveness	forgiven	forgave	unforgiving	unforgiven	unforgivable	unforgivably
fork	forked	forking	forks
forlorn	forlornly
form	formation	formations	formed	forming	forms	formless	formlessness
formal	formally	formality	formalities	formalise	formalised	formalisation	formalising	formalize	formalized	formalization	formalizing	formalism	formalist	formalists
format	formatted	formatting	formats
former	formerly
formidable	formidably
formula	formulae	formulas	formulate	formulated	formulating	formulation	formulations	reformulate	reformulated	reformulating	reformulation	reformulations
forth
fortnight	fortnights	fortnightly
fortune	fortunate	fortunately	fortunes	unfortunately	unfortunate
forward	forwards	forwarding	forwarded	forwarder	forwarders
foundation	foundations
four	fours	forties	forty	fortyish	fourteen	fourteenth	fourth	fourthly	fortieth	th
fox	foxes	foxy	foxier	foxiest	foxiness	foxily
fraction	fractions	fractionally	fractional
fragment	fragmenting	fragments	fragmented	fragmentary	fragmentation
frail	frailer	frailest	frailness	frailly	frailty	frailties
frame	framing	frames	framed
framework	frameworks
frank	franker	frankest	frankness	frankly
frantic	frantically
fraud	frauds	fraudster	fraudsters
freckle	freckles	freckled	freckling	freckly
free	freed	unfreed	freedom	freedoms	freeing	freely	freer	freest
frequent	frequents	frequently	frequenting	frequented	frequency	frequencies	infrequent	infrequently
fresh	freshness	fresher	freshest	freshly	freshen	freshening	freshens	freshened
friar	friars	friary
friend	friendly	unfriendly	friends	friendship	friendships	friendliness
fright	frights	frightful	frightens	frightening	frightened	frighten	frighteningly	frightener	frighteners	frightfully
fringe	fringes	fringed	fringing
fritter	fritters	frittered	frittering
frivolity	frivolities
frivolous	frivolousness	frivolously
fro
from
front	fronts	fronting	fronted	frontage	frontages	frontal	frontally
frontier	frontiers
frontispiece	frontispieces
frown	frowns	frowned	frowning
fruit	fruits	fruity	fruitless
fuel	fueled	fueling	fuelled	fuelling	fuels
fulfil	fulfilling	fulfilled	fulfils	fulfilment	fulfilments	unfulfilled	unfulfilling	fulfill	fulfills	fulfillment	fulfillments
full	fuller	fullest	fullness	fully
fumble	fumbles	fumbled	fumbling	fumbler	fumblers
fun	funny	funnily	funniest	funnier
fundraising
funeral	funerals
fur	furs	furry	furrier	furriest	furriness
furious	furiously
furnish	furnished	unfurnished	furnishes	furnishing	furnishings
furniture
furrow	furrows	furrowed	furrowing
further	furthest	furthering	furthers	furthered	furtherance
furtive	furtiveness	furtively
fury	furies
fuse	fuses	fused	fusing
fuss	fusses	fussy	fussier	fussiest	fussiness	fussily	fussed	fussing	fusser
futile	futility	futilities
future	futures	futuristic	futuristically
g
gain	gained	gaining	gains	gainer	gainers	gainful
gallery	galleries
gallop	gallops	galloped	galloping
game	games	gaming
gap	gaps
gape	gapes	gaped	gaping
garb	garbed	garbs
garden	gardener	gardeners	gardens	gardening	gardened
garment	garments
gash	gashed	gashing	gashes
gasp	gasps	gasped	gasping
gate	gates
gather	gathered	gathering	gatherings	gathers	gatherer	gatherers
gaunt	gaunter	gauntest	gauntness
gaze	gazes	gazed	gazing
gene	genes
general	generally	generalise	generalisable	generalised	generalisation	generalisations	generality	generalities	generalization	generalizations	generalize	generalizes	generalized	generalizing	generalises	generalising	generalist	generalists	generals	gen
generate	generated	generates	generating	generative	degenerative	generatively	degeneratively	generation	generations	generational
generous	generously	generosity
genial	genially	geniality	genialities
gentle	gently	gentleness	gentler	gentlest
gentleman	gentlemen	gentlemanly	ungentlemanly	gent	gents
gesture	gestured	gestures	gesturing
get	gets	getting	got	gotten	gotta	gotcha
getaway	getaways
ghastly	ghastliness
ghost	ghosts	ghostly
giddy	giddier	giddiest	giddiness	giddily
gig	gigs
gigantic	gigantically
giggle	giggles	giggled	giggling	giggler	gigglers
ginger	gingerly
girl	girls	gal	gals	girlish	girlishness	girlishly	girly	girlie	girlies
girth	girths
gist	gists
git	gits
give	gave	given	gives	giving	giver	givers	gimme
glad	gladder	gladdest	gladly	gladness	gladden	gladdens	gladdened	gladdening
glade	glades
glamour	glamours	glamourize	glamourizes	glamourized	glamourizing	glamourous	glamor	glamors	glamorize	glamorizes	glamorized	glamorizing	glamorous	glamorously	glamourously	unglamorous
glance	glanced	glances	glancing
glare	glares	glared	glaring	glaringly
glass	glasses	glassy	glassier	glassiest	glassiness	glassily
glaze	glazes	glazed	unglazed	glazing	glazings
gleam	gleams	gleamed	gleaming
glee	glees	gleeful	gleefulness	gleefully
glimmer	glimmers	glimmered	glimmering
glimpse	glimpsed	glimpsing	glimpses
glint	glinted	glinting	glints
glisten	glistens	glistened	glistening
glitter	glittered	glitters	glittering
gloom	glooms	gloomy	gloomier	gloomiest	gloominess	gloomily
glory	glories	glorious	gloriously	glorify	glorifies	glorified	glorifying	glorification	glorifications
glove	gloves	gloved
glow	glowed	glows	glowing	glowingly
gnaw	gnaws	gnawed	gnawing
go	goes	going	goings	goin	gone	went	gonna	gunna
goal	goalless	goals
goat	goats
god	gods	goddess	godless	godly	godliness	godlike
gold	golden
gong	gongs
good	goodness	goodly	goody	goodies
gorgeous	gorgeousness	gorgeously
gospel	gospels
gossip	gossiped	gossiping	gossips	gossipy	gossiper	gossipers
govern	govt	governs	governor	governors	governing	governed	government	governments	governmental	governorship	intergovernmental	gov
grace	gracing	graces	gracefully	graceful	graced	graceless
gracious	graciousness	ungracious	ungraciously	graciously
grade	grades	graded	ungraded	grading	grader	graders
gradual	gradually
grain	grains	grainy
grand	grandsons	grandson	grandparents	grandparent	grandpa	grandpas	grandmother	grandmothers	grandma	grandmas	grandfather	grandfathers	granddaughters	granddaughter	grandchildren	grandchild	gran	grans	granddad	granddads
grandeur	grandeurs
grant	granted	granting	grants
grasp	grasped	grasping	grasps
grass	grasses	grassy	grassed	grassing
grate	grates	grated	grating	grater	graters
grateful	gratefully	ungrateful	ungratefully	ungratefulness
grave	graves	gravely	gravest	graver	graveness
gravity	gravities	gravitation	gravitational
great	greater	greatest	greatly	greatness
greed	greeds	greedy	greedier	greediest	greediness	greedily
green	greener	greenest	greenness	greenish	greeny	greens	greening
greet	greetings	greets	greeting	greeted
grey	greys	greyly	greyish	greyness	gray	grayly	grayish	grayness
grim	grimness	grimly
grin	grinning	grinned	grins
grip	gripped	gripping	grips
groan	groans	groaned	groaning
grocery	groceries
groom	groomed	grooming	grooms
grope	gropes	groped	groping	groper	gropers
gross	grossly	grossed	grosses	grossed	grossing
grotesque	grotesqueness	grotesquely
ground	grounded	grounds	grounding	groundless
group	grouped	grouping	groupings	groups	subgroup	subgroups
grow	grew	growing	grown	grows	growth	growths	grower	growers
grudge	grudges	grudged	grudging	ungrudging	grudgingly
grumble	grumbles	grumbled	grumbling	grumbler	grumblers
grunt	grunts	grunted	grunting
guard	guarded	unguarded	guarding	guards
guess	guessing	guesses	guessed	guessable	unguessable
guide	guiding	guides	guided	unguided	guidance
guile	guiles	guileless	guilelessness	guilelessly	guileful
guilty	guiltily	guilt	guiltless
gullible	gullibility
gulp	gulps	gulped	gulping	gulper	gulpers
gurgle	gurgles	gurgled	gurgling
gust	gusts	gusty	gustier	gustiest	gustily
gutter	gutters	guttering	gutterings
guy	guys
gymnasium	gymnasiums	gym	gyms
h
habit	habits	habitual	habitually	habituate	habituates	habituated	habituating	habituation
hail	hails	hailed	hailing
hair	hairy	hairs	haired
half	halves	halfway	halve	halved	halving
hallowed	unhallowed
halt	halted	halting	haltingly	halts
hammer	hammers	hammering	hammered
hand	handed	handedness	handful	handfuls	handing	hands	handwriting	handwritten
handiwork	handiworks
handle	handled	handles	handling	handler	handlers
handy	handier	handiest	handiness	unhandy	unhandier	unhandiest	handily
hang	hanged	hanging	hangings	hangs	hung	unhung	hanger	hangers
haphazard	haphazardness	haphazardly
happen	happened	happening	happenings	happens
happy	happier	happiest	happily	happiness	unhappy	unhappily	unhappiness	unhappier	unhappiest
hard	harden	hardened	hardening	hardens	harder	hardest	hardness	hardship	hardships	hardworking
hardly
harm	harms	harmless	harmlessly	harmfully	harming	harmful	harmed	unharmed
harmonise	harmonises	harmonised	harmonising	harmonisation	harmonize	harmonizes	harmonized	harmonizing	harmonization
harness	harnessed	harnesses	harnessing	unharnessed
harrow	harrows	harrowed	harrowing
harsh	harsher	harshest	harshness	harshly
harvest	harvests	harvesting	harvester	harvested
haste	hastes	hasten	hastens	hastened	hastening	hasty	hastily	hastier	hastiest	hastiness
hat	hats	hatter	hatters
hate	hatred	hatreds	hating	hates	hated	hateful	hatefully	hatefulness
haughty	haughtier	haughtiest	haughtiness	haughtily
haul	hauls	hauled	hauling	hauler	haulers	haulage	haulages
haunt	haunts	haunted	haunting	haunter	haunters
have	had	hadn	hasn	has	haven	haves	having	ve	hath
hay	hays
hazy	hazier	haziest	haziness	hazily
he	him	himself	his
head	headed	heading	headings	heads	headless	headship
headline	headlines
headlong
heal	heals	healed	healing	healings	healer	healers
health	healthier	healthiest	healthily	healthy	unhealthy	unhealthiest
heap	heaps	heaping	heaped
hear	heard	hearer	hearing	hearings	hears	unheard
heart	hearts	heartfelt	hearten	heartened	heartens	heartening	heartless	heartlessness	heartlessly	hearted	disheartening	disheartened	disheartens
heartache	heartaches
hearty	heartier	heartiest	heartiness	heartily
heat	heated	unheated	heating	heats	heater	heaters	reheat	reheated	reheating	reheats	preheat	preheats	preheated	preheating
heathen	heathens	heathenish	heathenism	heathendom	heathendoms
heave	heaves	heaved	heaving	heaver	heavers
heavy	heavier	heaviest	heavily	heaviness	heavies
heavyweight	heavyweights
hedgerow	hedgerows
heed	heeds	heeded	heeding	heedless	heedlessly
heel	heels
height	heights
hell	hells
hullo	hello	hallo
help	helped	helpful	helpfully	unhelpful	helpfulness	unhelpfully	helping	helpless	helplessly	helplessness	helps	helper	helpers
hem	hems
hen	hens
herald	heralds	heralded	unheralded	heralding	heraldic
here
heritage	heritages
hero	heroes	heroic	heroics	heroically	heroism
heroine	heroines
hesitate	hesitating	unhesitating	hesitatingly	unhesitatingly	hesitates	hesitated	hesitation	hesitations
hiccup	hiccups	hiccupped	hiccupping	hiccough	hiccoughed	hiccoughing	hiccoughs
hide	hid	hidden	unhidden	hides	hiding
high	higher	highest	highly	highs	highway	highways
hill	hills	hillside	hillsides	hilly
hinder	hinders	hindered	unhindered	hindering	hindrance	hindrances
hint	hinted	hinting	hints
hip	hips
hire	hiring	hires	hired	hirer	hirers
hiss	hisses	hissed	hissing
history	historian	historians	historic	historical	historically	histories	historicist	historicists	historicism	historicity
hit	hitting	hitter	hits	unhit
hitch	hitches	hitched	hitching	hitcher
hither
hitherto
hoarse	hoarseness	hoarsely
hoax	hoaxed	hoaxing	hoaxes	hoaxer	hoaxers
hold	held	unheld	holder	holders	holding	holdings	holds
hole	holes	holed	holing
hollow	hollows	hollowed	hollowing	hollower	hollowest	hollowness	hollowly
holy	holier	holiest	holiness	unholy	unholier	unholiest	unholiness
home	homeless	homelessness	homes
homesick	homesickness
homestead	homesteads
honest	honesty	honestly	dishonest	dishonesty	dishonestly
honour	honor	honorable	honorably	honorary	honored	honoured	honoring	honouring	honors	honours	honourable	honourably	hon
hood	hooded	hoods
hoof	hooves	hoofs
hoot	hoots	hooted	hooting	hooter	hooters
hope	hoped	hopeful	hopefuls	hopefully	hopefulness	hopeless	hopelessly	hopelessness	hopes	hoping
horizon	horizons
horrible	horribly	horribleness
horror	horrors
horse	horses	unhorsed
hospitable	hospitably	inhospitable	inhospitably
hospitality	hospitalities
hot	hotly	hotness	hotter	hottest
hotel	hotels	hotelier	hoteliers
hour	hourly	hours	hr	hrs
house	housed	housing	houses
hover	hovers	hovered	hovering
how
however
huddle	huddles	huddled	huddling
hug	hugging	hugged	hugs	hugger	huggers
huge	hugely	hugeness
hum	humming	hummed	hums
human	humans	humanity	nonhuman	nonhumans	humanly	inhuman	inhumanity	humanist	humanists	humanism	humanistic
humble	humbled	humbling	humbles	humbleness	humbler	humblest	humbly
humour	humourous	humourously	humorously	humor	humorous	humourless	humorless	humourlessly	humorlessly
hunch	hunches	hunched	hunching
hundred	hundreds	hundredth
hunger	hungry	hungrily	hungers	hungering	hungered
hunt	hunts	hunting	hunters	hunter	hunted
hurl	hurls	hurled	hurling	hurler	hurlers
hurry	hurries	hurried	unhurried	hurriedly	unhurriedly	hurrying
hurt	hurts	hurting	hurtful	unhurt
hurtle	hurtles	hurtled	hurtling
husband	husbands
hush	hushes	hushed	hushing
husky	huskier	huskiest	huskiness	huskily
hustle	hustles	hustled	hustling	hustler	hustlers
hypnotic	hypnotically
hypocrisy	hypocrisies
hypocrite	hypocrites	hypocritical	hypocritically
hysterical	hysterics	hysteric	hysterically
i	me	mine	my	myself	meself
ice	icy	icily	iced
idea	ideas
identify	identifiable	identification	identifications	identified	unidentified	identifies	identifying	identities	identity	unidentifiable	identifier	identifiers
idiot	idiots	idiotic	idiotically	idiocy	idiocies
idyll	idylls	idyllic	idyllically
if	ifs
ignominy	ignominies	ignominious	ignominiously
ignorant	ignorance	ignore	ignored	ignores	ignoring
ill	ills	illness	illnesses
illuminate	illuminates	illuminated	illuminating	illumination	illuminations
illusion	illusions
illustrate	illustrated	unillustrated	illustrates	illustrating	illustration	illustrations	illustrative	illustrator	illustrators
image	imagery	images	imaged	imaging
imagine	imagining	imagines	imagined	unimagined	imagination	imaginations	imaginative	imaginatively	imaginary	imaginable	unimaginable	unimaginably	imaginably	unimaginative	unimaginatively
immaculate	immaculateness	immaculately
immediate	immediacy	immediately	immediateness
immense	immensely	immensity	immenseness
imminent	imminently
impact	impacted	impacting	impacts
impatience	impatiences
impatient	impatiently
impending
imperious	imperiousness	imperiously
impersonal	impersonally	impersonality	impersonalities
impetuous	impetuousness	impetuously
implement	implements	implemented	implementing	implementation	implementations
imply	implied	impliedly	implies	implying
import	imported	importer	importers	importing	imports	importation	importations
important	unimportant	importantly	importance	unimportance
impose	imposed	imposes	imposing	imposition
impotence	impotences
impress	impressed	unimpressed	unimpressive	impresses	impressing	impressive	impressively	impression	impressionable	impressions
improve	improving	improves	improved	unimproved	improvement	improvements
impudent	impudently	impudence
impulse	impulses	impulsive	impulsiveness	impulsively
in	inner
incalculable	incalculably
inch	inches	inched	inching
incident	incidents
incidental	incidentally
incline	inclination	inclinations	inclined	inclines	inclining
include	included	includes	including	incl	inclusive	inclusion
increase	increased	increases	increasing	increasingly
incredulous	incredulously
indecision	indecisions
indeed
indemnify	indemnifies	indemnified	indemnifying	indemnification	indemnifications
indemnity	indemnities
indicate	indicated	indicates	indicating	indication	indications	indicative	indicator	indicators
indifferent	indifferently
indispensable	indispensably	dispensable
indisputable	indisputably
individual	individualised	individuality	individualism	individualist	individualists	individualistic	individually	individuals	industrialist	industrialists	industrialise	industrialisation	industrialised	industrialising	industrialises	industrialize	industrialization	industrialized	industrializing	industrializes
indulge	indulged	indulges	indulging	indulgent	indulgently	indulgence	indulgences
industrious	industriousness	industriously
industry	industrial	industrially	industries
ineffable	ineffably
inert	inertness	inertly
inevitable	inevitability	inevitably
infant	infants	infancy
infantile
infinite	infinitely
infinitesimal	infinitesimally
inflect	inflected	inflects	inflecting	inflection	inflections	inflectional
inflict	inflicted	inflicting	inflicts	infliction	inflictions
influence	influenced	influencing	influences	influential	uninfluenced
inform	informs	informing	informed	informer	informers	information	informational	info	informant	informants	uninformed	informative	informativeness	uninformative	uninformed	informatively
informal	informally	informality	informalities
infringe	infringes	infringed	infringing	infringement	infringements
inhabitant	inhabitants
initial	initials	initially
initiate	initiated	initiates	initiating	initiation	initiations	initiative	initiatives	initiator	initiators	uninitiated
injure	injured	injures	injuries	injuring	injury	uninjured	injurious
inkling	inklings
innocent	innocents	innocence	innocently
inquire	inquiry	inquiring	inquiries	inquires	inquired	inquirer	inquirers
inquisitive	inquisitiveness	inquisitively
inscrutable	inscrutableness	inscrutably	inscrutability
inset	insets
inside	insides	insider	insiders
insinuate	insinuates	insinuated	insinuating	insinuation	insinuations
insist	insistent	insistently	insisted	insisting	insists	insistence	insistences
insolent	insolently	insolence	insolences
inspect	inspected	inspecting	inspection	inspections	inspector	inspectors	inspects	insp
inspire	inspired	inspires	inspiring	inspiration	inspirations	inspirational	uninspired	uninspiring
instance	instances
instant	instants	instantly	instantaneous	instantaneously
instead
instinct	instinctive	instinctively	instincts	instinctual	instinctually
instruct	instruction	instructed	instructing	instructions	instructive	instructor	instructors	instructs	instructional	instructionally
insult	insults	insulted	insulting
insure	insuring	insures	insured	insurance	insurer	insurers	insurable	uninsurable	reinsure	reinsuring	reinsures	reinsured	reinsurance
intellectual	intellectualise	intellectualize	intellectually	intellectuals
intelligible	unintelligible	unintelligibly	intelligibly	intelligibility
intense	intensely	intenseness	intensification	intensified	intensifies	intensify	intensifying	intensity	intensities	intensive	intensively
intent	intently	intention	intentions	intentional	intentionally	unintentional	unintentionally
interest	interested	interesting	interests	uninterested	uninteresting	interestingly
interfere	interfering	interferes	interfered	interference
interior	interiors
interlope	interlopes	interloped	interloping	interloper	interlopers
interminable	interminably
internal	internalise	internalised	internalises	internalising	internalize	internalized	internalizes	internalizing	internally
international	internationals	internationally	internationalise	internationalised	internationalises	internationalisation	internationalize	internationalized	internationalizes	internationalization	internationalist	internationalists	internationalism
interpret	interpretation	interpretations	interpretative	interpreted	interpreting	interpretive	interprets	misinterpret	misinterpretation	misinterpretations	misinterpreted	misinterpreting	misinterprets	reinterpret	reinterpreted	reinterprets	reinterpreting	reinterpretation	reinterpretations	interpreter	interpreters
interrogate	interrogates	interrogated	interrogating	interrogatory	interrogation	interrogator	interrogators	interrogations
interrupt	interrupts	interrupting	interrupted	uninterrupted	interruption	interruptions
interval	intervals
intervene	intervened	intervenes	intervening	intervention	interventions	interventionist	interventionists
interview	interviewed	interviewing	interviewer	interviewers	interviews	interviewee	interviewees
intimate	intimated	intimates	intimating	intimation	intimations	intimacy	intimacies	intimately
into
intone	intones	intoned	intoning	intoner	intoners	intonation	intonations
intrepid	intrepidly	intrepidity	intrepidities
introduce	introduced	introduces	introducing	introduction	introductions	introductory	intro	intros	reintroduce	reintroduces	reintroduced	reintroducing	reintroduction	reintroductions
introspect	introspects	introspected	introspecting	introspective	introspection	introspections
intrude	intrudes	intruded	intruding	intruder	intruders
intrusion	intrusions
intuitive	intuitiveness	intuitively
invent	invents	invented	inventing	inventor	inventors	invention	inventions
invert	inverts	inverting	inverted
invite	inviting	invites	invited	uninvited	uninviting	invitation	invitations
involuntary	involuntariness	involuntarily
iron	ironed	irons	ironing	ironings
irrefutable	irrefutably
irrevocable	irrevocably
irritate	irritates	irritated	irritating	irritation	irritations
irs
isolate	isolated	isolates	isolating	isolation	isolationism	isolationist	isolationists
issue	issued	issues	issuing	issuer	issuers	issuance
it	its	itself
item	itemisation	itemise	itemised	itemises	itemising	items	itemization	itemize	itemized	itemizes	itemizing
ivory	ivories
jagged	jaggeder	jaggedest	jaggedness	jaggedly
jaunt	jaunts	jaunty	jauntier	jauntiest	jauntiness	jauntily
jaw	jaws
jealous	jealously	jealousy	jealousies
jerk	jerks	jerked	jerking	jerky	jerkily	jerkiness
jerry	jerries
jest	jests	jested	jesting	jester	jesters
jet	jets
jingle	jingled	jingles	jingling
job	jobs	jobless
jocular	jocularly	jocularity	jocularities
join	joined	joining	joins
joint	joints	jointly	jointed	disjointed
joke	jokes	joked	joking	joker	jokers	jokingly
jolly	jolliness	jollity
jolt	jolted	jolting	jolts
journey	journeys	journeying	journeyed
jovial	jovially	joviality	jovialities
joy	joyful	joyfully	joys	joyless	joyous	joyousness	joyously
jubilee	jubilees
judge	judged	judges	judging	judgment	judgments	judgement	judgements	judgemental	misjudge	misjudges	misjudged	misjudging	misjudgement	misjudgements	prejudge	prejudges	prejudged	prejudging	prejudgement	prejudgements
judicial	judicially	nonjudicial
judicious	judiciousness	judiciously	injudicious	injudiciousness	injudiciously
jug	jugs	jugful
july
jump	jumps	jumping	jumped	jumpy
junior	juniors	jr	jnr
jurisdiction	jurisdictions	jurisdictional
just	justly	unjust	unjustly
justice	justices
justify	justifiable	justifiably	justification	justifications	justified	justifies	justifying	unjustified	unjustifiable	unjustifiably
k
keen	keener	keenest	keenly
keep	keeper	keepers	keeping	keeps	kept
key	keys	keyed	keying
kick	kicks	kicking	kicked	kicker	kickers
kid	kids
kidnap	kidnaps	kidnaped	kidnaping	kidnaper	kidnapers	kidnapped	kidnapping	kidnapper	kidnappers
kill	kills	killed	killer	killers	killing	killings
kin	kinship	kinships
kind	unkind	kindly	unkindly	kindness	kinds	kinda	kinder	kindest
kindle	kindles	kindled	kindling
king	kings	kingdom	kingdoms
kitchen	kitchens	kitchenette	kitchenettes
knead	kneads	kneaded	kneading	kneader	kneaders
knee	knees	kneed	kneeing
kneel	kneels	kneeled	knelt	kneeling
knight	knights	knighthood	knightly	knightlier	knightliest	knightliness
knob	knobs
knock	knocks	knocking	knocked	knocker	knockers
knockout	knockouts
knot	knotted	knotting	knots	knotty	knottier	knottiest
know	knew	knowing	knowingly	known	knows	unknown	unknowing	unknowingly	dunno	unknowable	knowledge	knowledges	knowledgeable
knuckle	knuckles
l
laborious	laboriousness	laboriously
labour	labor	laboured	labouring	labours	labored	laboring	labors	labourer	labourers	laborer	laborers
lace	laced	lacy	lacier	laciest	laces	lacing	interlace	interlaces	interlaced
lack	lacked	lacking	lacks
laconic	laconically
ladder	ladders
laden	unladen
lag	lagging	lagged	lags
laggard	laggards	laggardly	laggardness
lair	lairs
lake	lakes
lame	lameness	lamely
lament	laments	lamented	lamenting	lamentable	lamentably	lamentation
lamp	lamps
land	landed	landing	landings	lands	landless
lane	lanes
language	languages
languid	languidness	languidly
lanky	lankier	lankiest	lankiness
lantern	lanterns
lap	laps
large	largely	larger	largest
lash	lashes	lashed	lashing	lashings
lassitude
last	lasted	lasting	lasts	lastly
latch	latches	latched	latching	unlatch	unlatches	unlatched	unlatching
late	lately	lateness	later	latest
latter	latterly
laugh	laughs	laughing	laughed	laughable
laughter
launch	launched	launching	launches	launcher	launchers
law	laws	lawyer	lawyers	lawful	lawfully	unlawful	lawless	lawlessness	unlawfully	lawmaker	lawmakers
lay	laid	laying	lays	lain
lazy	lazier	laziest	laziness	lazily
lead	leader	leaders	leadership	leading	leads	mislead	misleading	misleadingly	misled	led
leaded	unleaded	leaden	leadenly
lean	leans	leaning	leanings	leaned	leant
leap	leaping	leaps	leapt	leaped
learn	learned	learner	learners	learning	learns	learnt
leather	leathers	leathery	leatheriness
leave	leaves	leaving	leaver	leavers
leer	leers	leered	leering
left	lefts	leftist	leftists	lefthand	lefthanded	lefthander	lefthanders
leg	legs	legged	legging	leggings	leggy
legal	illegal	illegality	illegally	legality	legally	legalise	legalising	legalised	legalisation	legalize	legalizing	legalized	legalization
leisure	leisurely
length	lengthening	lengths	lengthy	lengthen	lengthened	lengthens	lengthways
lenient	leniently	lenience	leniency
less	lessen	lessened	lessening	lesser	least
lest
let	lets	letting	lemme
letter	letters
level	levelled	leveller	levelling	leveled	leveler	leveling	levels	levelly
liable	liability	liabilities
library	librarian	librarians	libraries	librarianship
licence	licences	license	licensed	licensing	licenced	licencing	licenses	unlicensed	unlicenced	licensee	licensees
lick	licks	licked	licking
lid	lids
lie	liar	liars	lied	lies	lying
lieu
life	lifetime	lifetimes	lifelike	lifesize	lifelong	lifeless	lifelessly
lift	lifted	lifting	lifts	lifter	lifters
light	lighted	lighten	lightened	lightens	lightening	lighter	lightest	lighting	lightly	lightness	lights	lightweight	lit	unlit
lightning	lightnings
like	liked	likes	liking	dislike	dislikes	disliked	disliking	likeable	likeably
likely	likelier	likeliest	likelihood	unlikely
lilt	lilts	lilted	lilting
limb	limbs
limit	limitation	limitations	limited	limiting	limits	unlimited	limitless	limitlessly
limn	limns	limned	limning	limner	limners
limp	limps	limped	limping	limper	limpers	limply
limpid	limpidness	limpidly	limpidity	limpidities
line	lines	lined	lining
linger	lingers	lingered	lingering	lingerer	lingerers
link	linkage	linkages	linked	unlinked	linking	links	linker	linkers
lip	lips
liquid	liquids	liquidity	liquidities
list	unlisted	lists	listed	listing
listen	listened	listener	listeners	listening	listens
literal	literally
literary
literature	literatures
lithe	litheness	lithely
litter	litters	littered	littering	litterer	litterers
little	littler	littlest
live	lived	liveliest	lively	liveliness	livelier	lives	living
livid	lividly
load	unload	unloads	unloading	unloaded	loads	loading	loaded
loathe	loathes	loathed	loathing	loather	loathers	loath
locality	localities
locate	located	locating	location	locations	locational	relocate	relocated	relocates	relocating	relocation
lock	unlocks	unlocking	unlocked	unlock	locks	locking	locked
locker	lockers
log	logging	logs	logged	loggings	logger	loggers
logic	illogical	illogically	logical	logically	logician	logicians
loiter	loiters	loitered	loitering	loiterer	loiterers
lone	lonely	loneliness	loner	loners	lonesome
long	longer	longest	longish
longing	longed	longs	longings	longingly	longingness
look	looked	looking	lookin	looks
loom	looms	loomed	looming
loose	loosely	loosen	loosens	loosened	loosening	loosenings
lord	lords	lordship	lordships	lordly	lorded	lording
lose	loser	losers	loses	losing	lost
loss	losses
lot	lots
lottery	lotteries
loud	loudness	loudly	loudest	louder
lounge	lounged	lounging	lounges
love	loved	unloved	loveless	lovely	lovelier	loveliest	loveliness	loves	loving	lovingly	lovable	lover	lovers	luv	luvs	lovey	loveys
low	lows	lowly	lowlier	lowliest	lower	lowered	lowest	lowering	lowers
loyal	loyalty	loyalties	loyally	loyalist	loyalists
lucid	lucider	lucidest	lucidness	lucidly	lucidity	lucidities
luck	lucky	luckily	luckiest	luckier	luckless	unlucky	unluckily	unluckiest	unluckier
ludicrous	ludicrousness	ludicrously
lull	lulls
lumber	lumbers	lumbered	lumbering	lumberer	lumberers
lump	lumped	lumping	lumps	lumpy	lumpiness
lunch	lunches	luncheon	luncheons	luncheonette	luncheonettes
lung	lungs
lurch	lurches	lurched	lurching
lure	lures	lured	luring
lurid	luridness	luridly
lurk	lurks	lurked	lurking
luxury	luxuries	luxurious	luxuriously	luxuriant	luxuriantly	luxuriance
m
machine	machinery	machines	machinist	machinists
mad	madness	madly	maddest	madder	madman	madden	maddens	maddened	maddening
magazine	magazines	mag	mags
magic	magical	magically	magician	magicians
magnificent	magnificence	magnificently
magnify	magnifies	magnified	magnifying	magnification
mail	mails	mailing	mailed
maim	maims	maimed	maiming
main	mains	mainly
maintain	maintained	unmaintained	maintaining	maintains	maintenance
majestic	majestically
majesty	majesties
major	majorities	majority	majors	maj
make	made	unmade	maker	makers	makes	making	makings	remake	remakes	remaking	remade
malaria	malarias
male	males	maleness
malicious	maliciousness	maliciously
malign	maligns	maligned	maligning	malignant	malignantly	nonmalignant	malignancy	malignancies
mallet	mallets
man	mankind	men	mens	manly	manhood	manliness	mans	manning	manned	unmanned
manage	managing	manages	managers	manager	manageress	manageresses	managed	management	managements	mismanage	mismanaged	mismanages	mismanaging	mismanagement	manageable	unmanageable	managerial
maniac	maniacs	maniacal	maniacally
manicure	manicures	manicured	manicuring	manicurist	manicurists
manner	manners	mannered
manufacture	manufactured	manufacturing	manufactures	manufacturers	manufacturer
many
map	maps	mapping	mapped	unmapped
mar	marring	marred	mars
marble	marbles	marbled	marbling	marbleize	marbleizes	marbleized	marbleizing
march	marched	marches	marching	marcher	marchers
mare	mares
margin	marginal	marginalise	marginalised	marginalising	marginalisation	marginalize	marginalized	marginalizing	marginalization	marginally	margins	marginality
mark	marked	markedly	unmarked	marker	markers	marking	markings	marks
market	marketed	marketing	markets	nonmarket	marketable	marketer	marketers	marketeer	marketeers
maroon	marooned	maroons	marooning
marry	marriage	marriages	married	marries	marrying	unmarried	remarry	remarries	remarried	remarrying	remarriage
marvel	marvels	marveled	marveling	marvelous	marvelously	marvelled	marvelling	marvellous	marvellously
masculine	masculinity	masculinities
masquerade	masquerades	masqueraded	masquerading	masquerader	masqueraders
mass	masses	massed	massing
master	masters	mastered	mastering	masterly	masterful	mastery
masterpiece	masterpieces
match	matching	matches	matched	unmatched	mismatch	mismatched	mismatches	mismatching
matrimony	matrimonial
matter	mattered	mattering	matters
maximum	maximums	max
may
maybe
maze	mazes
meagre	meager	meagerest	meagerer	meagreness	meagerness
mean	meaner	meanest	meanly	meanness
meaning	meaningful	meaningfulness	meaningfully	meaningless	meanings	means	meant
meantime
measure	measured	measurement	measurements	measures	measurable	measurably	immeasurably	measuring
meat	meats	meaty
mechanic	mechanics	mechanical	mechanically
medicine	medicines	medicinal	medicinally
medium
meek	meeker	meekest	meekness	meekly
meet	meeting	meetings	meets	met	unmet
member	members	membership	memberships
memory	memorial	memories	memorise	memorised	memorises	memorising	memorize	memorized	memorizes	memorizing	memorials
menace	menaced	menacing	menaces	menacingly
mental	mentality	mentally
mention	mentioned	mentioning	mentions	unmentioned
mercy	merciful	mercifully	mercifulness	mercies	merciless	mercilessly	mercilessness
mere	merely	merest
merit	merited	unmerited	meriting	merits
merry	merrier	merriest	merriness	merrily	merriment
message	messages
metal	metals	metallic	nonmetallic
mete	metes	meted	meting
method	methodical	methodological	methodologically	methodologies	methodology	methods	methodically
metropolis	metropolises
metropolitan
mid	midst
middle	middles	middling
might	mightn
mighty	mightily
mild	mildness	mildly	mildest	milder
mile	miles	mileage	mileages
mimic	mimics	mimicked	mimicking	mimicker	mimickers	mimick	mimicry
mince	minced	mincing	minces
mind	minded	mindless	mindlessness	mindful	mindfulness	minding	minds	minder	minders
minister	ministers	ministerial	ministering	ministered
minor	minorities	minority	minors
minute	minutes	min	mins
minutely	minuteness
miracle	miracles
miraculous	miraculously
mirror	mirrors	mirrored	mirroring
mirth	mirths	mirthless	mirthlessly	mirthful	mirthfulness	mirthfully
mischief	mischievous	mischievously
miss	missed	unmissed	misses	missing
mission	missions	missionary	missionaries
mist	mists	misty	mistier	mistiest	mistiness	mistily
mistake	mistaking	mistakes	mistakenly	mistaken	unmistakably	unmistakable
mister	mr
mite	mites
mix	mixing	mixes	mixed	mixer	mixers	mixture	mixtures
moan	moans	moaned	moaning	moaner	moaners
mob	mobbed	mobbing	mobs
mobile	mobility	mobilities	immobile	immobility
mock	mocking	mocked	mocks	mocker	mockers	mockingly	mockery	mockeries
model	models	modelling	modelled	modeling	modeled	modeller	modellers
moderate	moderateness	moderately	immoderate	immoderately	moderates	moderation	moderations
modern	modernise	modernised	modernising	modernisation	modernize	modernized	modernizing	modernization	modernity	modernism	modernisms	modernist	modernists
modest	modesty	modestly
modify	modification	modifications	modified	modifies	modifying	unmodified	modifier	modifiers
modulate	modulates	modulated	modulating	modulation	modulations
moist	moister	moistest	moistness	moistly	moisten	moistens	moistened	moistening	moistener	moisteners	moisture	moistures	moisturise	moisturised	moisturising	moisturize	moisturized	moisturizing	moisturiser	moisturisers	moisturizer	moisturizers
molasses
moment	momentary	momentarily	moments
momentous	momentousness	momentously
monday	mon	mondays
money	moneys	monies
monologue	monologues
monopoly	monopolies	monopolise	monopolises	monopolised	monopolising	monopolisation	monopolize	monopolizes	monopolized	monopolizing	monopolization	monopolistic	monopolist	monopolists
monotone	monotones
monotony	monotonies	monotonous	monotonously	monotonousness
month	monthly	months
mood	moods	moody	moodiness	moodily
moon	moons	moonlight	moonlit
mop	mops	mopped	mopping
moral	morals	morally	morality	moralist	moralists	moralistic	moralistically
more
mormon	mormons	mormonism
morning	mornin	mornings
mortal	mortals	mortally	mortality	mortalities	immortal	immortally	immortality	immortalities	immortalize	immortalizes	immortalized	immortalizing	immortalise	immortalises	immortalised	immortalising
mortgage	mortgaged	unmortgaged	mortgaging	mortgages	mortgagee	mortgagees
most	mostly
mother	mothers	motherhood	mothered	mothering	motherly	mum	mom	mummy	mums	mam	mams	mammy	mammies	mommy	mommies	mama	mamas
motion	motions	motioning	motioned	motionless
mould	moulds	moulded	moulding	mouldy	mold	molds	molded	molding	moldy
mound	mounded	mounds
mount	mt	mounts	mounted	mounting
mountain	mountains	mountainside	mountainous	mountaineer	mountaineers	mountaineering
mouse	mice
mouth	mouthful	mouths	mouthed	mouthing	mouthings	mouther	mouthers
move	moved	movement	moves	moving	movements	unmoving	unmoved	movable	moveable	unmovable	unmoveable	immovable	immoveable	mover	movers
mow	mows	mowed	mowing	mower	mowers
mrs	missus	missuses	ms
much
muffle	muffles	muffled	muffling	muffler	mufflers
multiply	multiplying	multiplies	multiplied	multiplication	multiplier	multipliers
multitude	multitudes
mumble	mumbles	mumbled	mumbling	mumbler	mumblers
murmur	murmurs	murmured	murmuring	murmurer	murmurers
muscle	muscles
muse	muses	mused	musing
music	musical	musicals	musician	musicians	musically	musique
must	mustn
mute	mutes	muting	mutely	muted	muteness
mutter	mutters	muttered	muttering	mutterer	mutterers
mutual	mutually	mutuality
myriad	myriads
mystery	mysteries	mysterious	mysteriously
mythology	mythologies	mythologize	mythologizes	mythologized	mythologizing	mythologist	mythologists
nail	nails	nailing	nailed
naive	naively	naivety	naiveties
naked	nakedness
name	named	unnamed	names	naming	namely	nameless
narrate	narrated	narrates	narrating	narrator	narrators	narrative	narratives	narration	narrations
narrow	narrowed	narrower	narrowest	narrowing	narrowly	narrowness	narrows
nasty	nastiness	nastily	nastier	nastiest
nation	national	nationals	nationally	nationwide	nations	nationalism	nationalisms	nationalisations	nationalist	nationalists	nationalistic	nationalistically	nationalise	nationalised	nationalising	nationalisation	nationalize	nationalized	nationalizing	nationalization	nationhood	nationhoods	nationality	nationalities
nature	natural	unnatural	unnaturally	naturally	natures	naturalistic	naturalistically	naturalness	naturalist	naturalists	naturalism
nausea	nauseates	nauseated	nauseating	nauseatingly	nauseous	nauseousness	nauseously	nauseas
near	nearby	nearer	nearest	nearly	nearness	nears	nearing	neared	nearside
neat	neatness	neatly	neatest	neater
necessary	necessarily	unnecessarily	unnecessary
necessity	necessities
neck	necks	necking	necked
need	needed	unneeded	needing	needless	needs	needn	needlessly
negate	negates	negated	negating	negation
negative	negatively	negatives	negativism	negativity
neglect	neglects	neglecting	neglected
negligent	negligence	negligently
neighbour	neighbor	neighborhood	neighborhoods	neighbors	neighbourhood	neighbourhoods	neighbouring	neighboring	neighbours
neither
nerve	nerves
nervous	nervously	nervousness
net	nets	netted	netting	nettings
network	networked	networking	networks
never
nevertheless
new	newer	newest	newly	newness	renew	renewed	renews	renewing	renewable	renewal	renewals
newcomer	newcomers
news	newsy
newsletter	newsletters
newspaper	newspapers
next
nibble	nibbles	nibbled	nibbling	nibbler	nibblers
nice	nicest	nicer	niceness	nicely
nicety	niceties
night	nightly	nights	goodnight	midnight
nightfall	nightfalls
nightmare	nightmares	nightmarish
nimble	nimbleness	nimbly
nine	nines	nineteen	nineteenth	nineties	ninetieth	ninety	ninth
no	nobody	noone	nothing	nothingness	nowhere	nope
nod	nodding	nodded	nods
noise	noises	noisy	noisier	noisily
non
nonchalant	nonchalance	nonchalantly
nondescript
none
noon	noons	forenoon	forenoons
nor
north	northerly	northerlies	northwest	nw	northwestern	northwesterner	northwesterners	northeast	ne	northeastern	northeasterner	northeasterners	northwards	northward	northern	northerner	northerners	northbound
nose	noses	nosed	nosing
nostril	nostrils
not	t	nt
note	notable	notes	noting	notably	noted
notebook	notebooks
notice	noticeable	noticeably	noticed	unnoticed	notices	noticing
notify	notifies	notified	notifying
notoriety
nourish	nourishes	nourished	nourishing	nourishment	nourishments
novel	novels	novelist	novelists
novelty	novelties
now	nowadays
numb	numbed	numbs	numbing	numbest	numbness	numbly
number	numbered	unnumbered	numberless	numbering	numbers	nos
numerous
nurse	nursing	nurses	nursed
o
oath	oaths
obey	obeys	obeying	obeyed	obedience	obediently	obedient
object	objects	objected	objecting	objector	objectors	objection	objections	objectionable	unobjectionable	objectionably
oblivious	obliviousness	obliviously
observe	observable	observation	observations	observational	observatory	observed	observer	observers	observes	observing	observant	observantly	nonobservant	unobserved	unobservant
obsolete	obsolescence	obsolescences	obsolescent
obtain	obtainable	obtained	obtaining	obtains	unobtainable
obtrusive	obtrusiveness	unobtrusive	unobtrusiveness	unobtrusively	obtrusively
occasion	occasional	occasionally	occasions
occupation	occupational	occupations
occupy	occupancy	occupant	occupants	occupied	unoccupied	occupier	occupiers	occupies	occupying
occur	occurred	occurrence	occurrences	occurring	occurs	reoccur	reoccurred	reoccurring	reoccurs
odd	odds	odder	oddest	oddness	oddly	oddity	oddities
odour	odours	odourless	odor	odors	odorless	odorous
of
off	orf
offence	offences	offense	offenses	offensive	offensively	inoffensive	inoffensively	offensiveness	unoffensive	inoffensiveness
offend	offends	offended	offending	offender	offenders
offer	offered	offering	offerings	offers	offerer	offerers	offerors	offeror
office	officer	officers	offices
official	officially	officialdom	officials	unofficial	unofficially
officious	officiously	officiousness
often	oft
oil	oily	oiliness	oils	oiled	unoiled
old	older	oldest	oldish	oldy	oldies	olden
omelette	omelettes
ominous	ominousness	ominously
omit	omitting	omitted	omits	omission	omissions
on	onto
once
one	ones	oneness	oneself
online
only
ooze	oozes	oozed	oozing
opaque	opaqueness	opaquely	opacity	opacity	opacities
open	opening	openings	openly	openness	opens	opened	unopened	opener	openers	reopen	reopens	reopened	reopening
operate	operated	operates	operating	operation	operations	operator	operators	operational	operationally	operative	operatives
opinion	opinions	opinionated
opponent	opponents
opportunity	opportunities
oppose	opposing	opposes	opposed	opposition	oppositional	unopposed
opposite	opposites
optimism	optimisms
option	optional	options
or
order	ordered	ordering	orderly	orderliness	orderlies	orders	unordered	reorder	reordered	reordering	reorders
ordinary	ordinarily	ordinariness
organize	organisation	organisations	organise	organised	disorganised	disorganized	unorganised	organises	organising	organization	organizations	organized	organizes	organizing	organisational	organisationally	organiser	organisers	organizer	organizers	organizational	organizationally	reorganise	reorganises	reorganised	reorganising	reorganisation	reorganisations	reorganize	reorganizes	reorganized	reorganizing	reorganization	reorganizations
origin	origins	originate	originates	originated	originating	originator	originators	original	originally	originality	unoriginal	originals
ostensible	ostensibly
ostentatious	ostentatiously
other	others	otherness
ought	oughtn
out	outer	outside	outsider	outsiders	outward	outwardly	outwards	outs	outta
outbuilding	outbuildings
outcome	outcomes
outdated
outline	outlined	outlines	outlining
outlying
outrage	outrages	outraged	outrageous	outrageously	outraging
outstretched
outweigh	outweighs	outweighed	outweighing
oven	ovens
over	overly
overdo	overdid	overdoes	overdoing	overdone
overgrow	overgrown	overgrows	overgrowing	overgrew
overland
overlook	overlooked	overlooking	overlooks
overrun	overrunning	overran	overruns
overturn	overturns	overturned	overturning
overwhelm	overwhelmed	overwhelming	overwhelmingly	overwhelms
overwork	overworking	overworked	overworks
owe	owed	owes	owing
own	owned	owner	owners	ownership	owning	owns
pace	pacing	paced	paces
pack	packs	packing	packed	package	packages	packaging	packaged	packer	packers	unpack	unpacking	unpacked	unpacks	packet	packet	packets
pad	pads	padding	padded
page	pages	pp	paged	paging	pager	pagers	pagings
pail	pails	pailful
pain	pains	pained	paining	painful	painfully	painkiller	painkillers	painless	painlessness	painlessly
painstaking	painstakingly
paint	painted	painter	painters	painting	paintings	paints	unpainted	repaint	repaints	repainted	repainting
pair	pairs	pairing	paired	unpaired
pale	paling	pales	paled	paleness
pallid	pallider	pallidest	pallidness	pallidly
pallor	pallors
palm	palms
palpable	palpably	impalpable	impalpably
palpitate	palpitates	palpitated	palpitating	palpitation	palpitations
pamphlet	pamphlets	pamphleteer	pamphleteers
pan	pans
pandemonium	pandemoniums
pane	panes
panel	panelled	panelling	panels
panic	panicked	panicking	panics	panick	panicky	panickier	panickiest
pant	panted	panting
pantomime	pantomimes	panto	pantos
paper	papers	papered	papering
paperwork	paperworks
parade	paraded	parading	parades
paragraph	paragraphing	paragraphs	para	paras
parallel	paralleled	parallelled	parallelling	parallels	unparalleled	paralleling	parallelism
pardon	pardons	pardoned	pardoning	pardonable	unpardonable
paroxysm	paroxysmal
parrot	parrots
part	parted	parting	partly	parts	partial	partially	pt	pts
particle	particles
particular	particulars	particularly	particularity	particularities
partition	partitioned	partitioning	partitions
party	parties
pass	passed	passes	passing	passable	passably	impassable	impassably	passer	passers
passage	passages
passenger	passengers
passion	passionate	passionately	passions
passport	passports
past
pastime	pastimes
pasture	pastures
pat	patting	patted	pats
patch	patched	patching	patches
patent	patents	patenting	patented	patently
paternal	paternally	paternalism	paternalisms
path	paths
pathetic	pathetically
pathos
patient	patiently	patience	patients
patriarch	patriarchs	patriarchy	patriarchal
patron	patrons	patroness	patronesses	patronize	patronizes	patronized	patronizing	patronizer	patronizers	patronise	patronises	patronised	patronising
pattern	patterns	patterned	patterning
pause	pausing	pauses	paused
pave	paved	unpaved	paves	paving	pavement	pavements
pawn	pawns
pay	paid	paying	payment	payments	pays	unpaid	payer	payers	payable
peace	peaceful	peacefully	peaceable
peak	peaks	peaked	peaking
pearl	pearls	pearly	pearlier	pearliest
peculiar	peculiarly	peculiarity	peculiarities
peep	peeps	peeped	peeping	peeper	peepers
peer	peerage	peers	peerless
peered	peering
peeve	peeves	peeved	peeving	peevish
peg	pegging	pegged	pegs
pen	pens
pencil	pencils
pendulum	pendulums
penetrate	penetrated	penetrates	penetrating	penetration	penetrations	interpenetration	interpenetrations
pensive	pensiveness	pensively
people	peoples
per
percent	percentage	percentages
perch	perches	perched	perching
peremptory	peremptorily
perfect	perfected	perfecting	perfectly	perfects	perfection	imperfect	imperfectly	imperfection	imperfections	perfectionist	perfectionists
perform	performs	performing	performer	performers	performed	performance	performances
perhaps
peril	perils	perilous	perilously	perilling
period	periodic	periods	periodical	periodically	periodicals
perish	perishes	perished	perishing	perishable	nonperishable	imperishable	imperishably
perk	perked	perking	perks	perky	perkier	perkiest	perkiness	perkily
permanent	permanently	impermanent	impermanence	permanence	permanency	permanences
permit	permission	permits	permitted	permitting	permissible
perpetrate	perpetrates	perpetrating	perpetrated	perpetrator	perpetrators	perpetration
perplex	perplexes	perplexed	perplexing	perplexity	perplexities
persist	persisted	persistence	persistency	persistent	persistently	persisting	persists
person	personal	personally	persons
personality	personalities
personify	personifies	personified	personifying	personification	personifications
personnel
perspective	perspectives
persuade	persuasion	persuasions	persuades	persuaded	persuading	persuasive	persuasively
pert	perter	pertest	pertness	pertly
pertinent	pertinently
pervade	pervades	pervaded	pervading
perverse	perverseness	perversely	perversity	perversities
pervert	perverts	perverted	perverting	perversion	perversions
pet	pets
petal	petals
petulant	petulantly
phase	phased	phases	phasing
philosophy	philosopher	philosophers	philosophical	philosophically	philosophies	philosophise	philosophised	philosophises	philosophising	philosophize	philosophized	philosophizes	philosophizing	philosophic	philosophe	philosophes
phlegmatic	phlegmatically
phrase	phrases	phrasing	phrased	phrasings
physical	physically
physician	physicians
physique	physiques
pick	picks	picking	pickers	picker	picked	unpicked
picket	picketing	picketed	pickets	picketer	picketers
picture	pictured	pictures	picturing	pic	pics
picturesque	picturesqueness	picturesquely
piece	pieces
pike	pikes
pile	piling	piles	piled
pilgrim	pilgrims	pilgrimage
pilot	pilots	piloted	piloting
pin	pins	pinned	unpinned	pinning
pine	pines	piney
pink	pinks	pinkness	pinkest	pinker	pinkish	pinky
pioneer	pioneered	pioneering	pioneers
pipe	pipes	piped	piping	pipings	piper	pipers
piquant	piquantly	piquantness
pistol	pistols
pit	pitted	pitting	pits
pitch	pitched	pitches	pitching	pitcher	pitchers
pith	piths	pithy	pithier	pithiest	pithiness	pithily
pity	pitying	pitiful	pitiless	pitilessly	pitifully	pities	pitied	unpitied
placard	placards
place	placed	places	placing	placement	placements
placid	placidly	placidity	placidities
plain	plainer	plainest	plainly	plains
plaintive	plaintively
plan	planned	planner	planners	planning	plans	unplanned
plane	planes	planed	planing	planer	planers
plant	planted	unplanted	planting	plants	planter	planters
plaster	plastered	plasters	plastering
plastic	plastics	plasticity
plate	plates	plated	plating
platform	platforms
play	played	player	players	playing	plays	replay	replays	replaying	replayed	playable	unplayable	playful	playfulness	playfully
plea	pleas
plead	pleaded	pleading	pleads
please	pleasant	pleasantly	pleasantness	pleased	pleases	pleasing	unpleasant	unpleasantly	unpleasantness	unpleasantnesses	pleasantry	pleasantries	displease	displeased	displeasing
pleasure	pleasures	displeasure	pleasurable	pleasurably
plenty	plentiful
plod	plodding	plodded	plods	plodder	plodders
plot	plotted	plotting	plots	plotter	plotters
plough	ploughs	ploughed	ploughing	ploughman	ploughmen	plowed	plowing	plows
pluck	plucks	plucked	plucking	plucker	pluckers
plump	plumped	plumping	plumper	plumpest	plumpness	plumply	plumps
plunge	plunged	plunges	plunging	plunger	plungers
pocket	pockets	pocketed	pocketing
poignant	poignantly
point	pointed	pointedly	pointing	pointless	pointlessly	points	pointer	pointers	midpoint	midpoints
poise	poises	poised	poising
poison	poisons	poisonous	poisoning	poisoned	poisoner	poisoners
poke	pokes	poked	poking	poker	pokers
pole	poles
polish	polishing	polishes	polished
politic	politics	political	unpolitical	politically	nonpolitical	politicize	politicizes	politicized	politicizing	politicization	politicise	politicises	politicised	politicising	politicisation	politician	politicians
pompous	pompousness	pompously	pomposity
ponder	ponders	pondered	pondering	ponderer	ponderers
ponderous	ponderousness	ponderously
pool	pools	pooling	pooled
poor	poorer	poorest	poorly	poorness
pop	popped	popping	pops
popular	popularity	popularly	unpopular	unpopularity	popularise	popularised	popularising	popularisation	popularisations	populariser	popularisers	popularize	popularized	popularizing	popularization	popularizer	popularizers	popularizations
portend	portends	portended	portending	portent
porter	porters
portion	portions
portly	portlier	portliest	portliness
position	positions	positioning	positioned	positional	reposition	repositions	repositioning	repositioned
positive	positives	positively	positivist	positivists	positivism	positivity
possess	possessed	possesses	possessing	possessive	possession	possessions	possessor	possessors	repossess	repossesses	repossessed	repossessing	repossession	repossessions
possible	possibles	possibilities	possibility	possibly	impossibility	impossible	impossibly
post	posted	poster	posters	posting	posts	postal	postage	postages
posture	postures	postural	postured	posturing	posturings
pot	pots	potted	potting
potent	potently	impotent	impotently
pouch	pouches
pound	pounds	pounding	pounder	pounders	pounded	poundings	poundage	poundages
pour	pours	pouring	poured
pout	pouts	pouted	pouting	pouter	pouters
poverty
power	powered	powerful	powerfully	powers	powerless	powerlessly	powerlessness
practical	practically	practicable	impractical	impracticable	impracticably	practicality	practicalities	impracticality	impracticalities
practise	practises	practised	practising	practice	practices	practicing	practiced
prairie	prairies
pray	prays	praying	prayers	prayer	prayed
pre
precede	preceded	precedence	precedent	precedents	precedes	preceding	unprecedented
precious	preciousness
precipitate	precipitates	precipitated	precipitating	precipitation
precise	imprecise	precisely	precision
preclude	precludes	precluded	precluding
preface	prefaces	prefaced	prefacing
prefer	prefers	preferring	preferred	unpreferred	preferable	preferably	preference	preferences	preferential	preferentially	preferment	preferments
pregnant	pregnancy
preliminary	preliminaries
premature	prematurely
premonition	premonitions
preoccupation	preoccupations
preoccupy	preoccupies	preoccupied	preoccupying
prepare	preparation	preparations	prepared	prepares	preparing	unprepared	preparatory	prep	preparedness
prepossessing
preposterous	preposterously
present	presenter	presenters	presentation	presentations	presentational	presented	presenting	presents	presentable	unpresentable	presentably	presence	presently
preserve	preserved	preserves	preserving	preservation	preservative	preservatives
press	pressed	unpressed	presses	pressing
pressure	pressured	pressures	pressuring	pressurise	pressurize	pressurised	pressurized	pressurising	pressurizing	pressurisation	pressurization
pretty	prettier	prettiest	prettily	prettiness
prevent	prevented	preventing	prevention	prevents	preventable	preventative	unpreventable	preventive
previous	previously
price	priced	prices	pricing	priceless	pricey
pride	prides
primitive	primitiveness	primitively
principal	principally	principals
print	printed	printer	printers	printing	prints	printable	reprint	reprints	reprinting	reprinted
prison	prisons	prisoners	prisoner	imprison	imprisoning	imprisons	imprisoned	imprisonment	imprisonments
private	privately	privacy
prize	prized	prizes
probable	probably	probability	probabilities	probabilistic	probabilistically	improbable	improbably	improbability	improbabilities
problem	problems	problematic
proceed	procedural	procedure	procedures	proceeded	proceeding	proceedings	proceeds
process	processed	processes	processing	unprocessed	reprocess	reprocesses	reprocessed	reprocessing	reprocessings	processor	processors	processer	processers
procession	processions	processional
prod	prodding	prodded	prods
prodigal	prodigals	prodigally
produce	produced	producer	producers	produces	producing
product	products	production	productions	productive	productively	unproductive	productivity
profane	profaneness	profanely	profanity	profanities
profession	professions
professional	professionally	professionals	professionalism	unprofessional
professor	professors	professorship	professorships	prof	profs
proffer	proffers	proffered	proffering
profile	profiled	profiles	profiling
profit	profited	profiting	profits	profitable	unprofitable	profitability	unprofitability	profitably	profitless
profound	profounder	profoundest	profoundness	profoundly
progress	progressed	progresses	progressing	progressive	progressively	progression	progressions
prohibit	prohibits	prohibited	prohibiting	prohibitory	prohibition	prohibitions	prohibitionist	prohibitionists	prohibitive	prohibitively
project	projected	projecting	projection	projections	projects	projective
projectile	projectiles
prolong	prolongs	prolonged	prolonging	prolongation
prominent	prominently
promise	promised	promises	promising	unpromising
promote	promoted	promoter	promoters	promotes	promoting	promotion	promotions	promotional	promo	promos
prompt	prompts	promptly	prompting	prompted
prone	proneness
proof	proofs	proofing	proofed
proofread	proofreads	proofread	proofreading
prop	propping	propped	props
proper	properly	improper	improperly
property	properties
prophecy	prophecies
prophesy	prophesies	prophesied	prophesying
proportion	proportioned	proportional	proportionality	proportionally	proportionate	proportionately	proportions
proposition	propositions
proprietor	proprietors	proprietorship	proprietorships	proprietary	proprietorial	proprietorially
prospect	prospects	prospecting	prospected	prospective	prospector	prospectors
protect	protected	protecting	protection	protections	protectionism	protectionist	protectionists	protective	protects	unprotected	protector	protectorate	protectorates	protectors	protectively	protectiveness
protest	protested	protesting	protests	protestor	protestors	protester	protesters	protestation	protestations
proud	proudly	proudest	prouder	proudness
prove	proved	proven	proves	proving	unproven
provide	provided	provides	providing	provider	providers
providence	providences	providential
provision	provisions
provoke	provoked	unprovoked	provokes	provoking	provocation	provocations	provocative	provocativeness
public	publicity	publicly
publication	publications
publish	published	publisher	publishers	publishes	publishing	unpublished	republish	republished	republishes	republishing
pucker	puckers	puckered	puckering
pudgy	pudginess
puff	puffed	puffing	puffs	puffy	puffier	puffiest	puffiness
pull	pulled	pulling	pulls
pulse	pulses	pulsed	pulsing
pump	pumps	pumping	pumped
punch	punched	punches	punching
punish	punishable	nonpunishable	punishing	punishes	punished	punishment	punishments
punitive	punitively
pupil	pupils
purchase	purchased	purchaser	purchasers	purchases	purchasing	repurchase	repurchased	repurchaser	repurchasers	repurchases	repurchasing
pure	purest	purer	purely	purity	impure	impurity	impurities	purist	purists	pureness
puritan	puritans	puritanism	puritanical	puritanically
purple	purplish
purport	purports	purported	purportedly	purporting
purpose	purposes	purposely	purposeful	purposefully	purposefulness	purposeless	purposelessness	purposive
purr	purrs	purred	purring
purse	purses	pursed	pursing
pursue	pursued	pursuer	pursuers	pursues	pursuing	pursuant	pursuance
push	pushing	pushes	pushed	pushy	pusher	pushers
put	puts	putting
putt	putted	putts	putter	putters
puzzle	puzzles	puzzled	puzzling	puzzler	puzzlers	puzzlement	puzzlements
quality	qualities
qualm	qualms	qualmish
quarrel	quarreled	quarrels	quarreling	quarrelsome	quarrelled	quarrelling
quaver	quavers	quavered	quavering
queer	queers	queerer	queerest	queerness	queerly
querulous	querulously	querulousness
query	queried	querying	queries
question	questions	questioned	questioning	questioningly	questionable	questionably	unquestionably	questioner	questioners	unquestioned	unquestioning	unquestionable	unquestionability
quibble	quibbles
quick	quickness	quickly	quickest	quicker
quiet	quieter	quietest	quietly	quietness	quieten	quietens	quietened	quietening
quintessence	quintessential	quintessentially
quirk	quirks	quirky	quirkier	quirkiest	quirkiness
quit	quitting	quits	quitter	quitters
quite
quiver	quivers	quivered	quivering
quizzical	quizzically
rabbit	rabbits
race	racecourse	raced	races	racing	racer	racers	racial	racially	nonracial	racialism	racialist	racialists
rack	racks	racked	racking	rackings
radiance	radiances	radiant	radiantly
radius	radiuses
rage	rages	raged	raging	enrage	enrages	enraged	enraging
ragged	raggeder	raggedest	raggedness	raggedly
rain	rains	raining	rained	raindrops	raindrop	rainy	rainier	rainiest
rainbow	rainbows
raise	raised	raises	raising	raiser	raisers
rake	rakes	raked	unraked	raking
ramble	rambles	rambled	rambling	rambler	ramblers
rank	ranked	ranking	ranks
rapid	rapidly	rapidity
rapt	raptness	raptly
rapturous	rapturously
rare	rarest	rarer	rareness	rarely	rarity	rarefied
rash	rashes	rashness	rashly
rasp	rasps	raspy	raspier	raspiest	rasping	rasped
rate	rated	rates	rating	ratings	rateable
rather
rattle	rattles	rattled	rattling	rattler	rattlers
raw	rawness	rawest	rawer
reach	reached	reaches	reaching
react	reacted	reacts	reacting	reaction	reactionaries	reactionary	reactions	reactive	reactivity	reactor	reactors	reactant	reactants
read	reader	readers	reading	readings	reads	misread	misreads	misreading	readability	readable	unreadable	reread	rereads	rereading	unread
readjust	readjusts	readjusted	readjusting	readjustment	readjustments
ready	readily	readiness	unready
real	unreal	unrealistic	unrealistically	unreality	realistic	realistically	reality	realities	realist	realists	realism	realisms
realise	realize	realization	realizations	realized	unrealised	unrealized	realizes	realizing	realisation	realisations	realised	realising	realises	realisable	realizable
really
rear	reared	rearing	rears
rearrange	rearranges	rearranged	rearranging	rearrangement	rearrangements
reason	reasonable	unreasonable	reasonableness	unreasonableness	reasonably	unreasonably	reasoned	reasoning	reasons
rebel	rebels	rebelled	rebelling	rebellings	rebellion	rebellions	rebellious	rebelliousness	rebelliously
rebound	rebounds	rebounded	rebounding
rebuff	rebuffs	rebuffed	rebuffing
rebuke	rebukes	rebuked	rebuking
rebut	rebutting	rebutted	rebuts	rebuttal	rebuttals
recall	recalls	recalled	recalling
recede	recedes	receded	receding
receipt	receipts
receive	received	receives	receiving	receivable	receiver	receivers	receivership	receiverships
reception	receptions	receptionist	receptionists
recite	recites	recited	reciting	reciter	reciters	recitation	recital	recitals	recitalist	recitalists	recitative
reckless	recklessness	recklessly
reckon	reckoned	reckoning	reckons
recognize	recognise	recognised	recognises	recognising	recognition	recognized	recognizes	recognizing	recognisable	unrecognisable	unrecognizable	recognisably	unrecognised	unrecognized	recognizable	recognizably
recoil	recoils	recoiled	recoiling
recollect	recollects	recollected	recollecting	recollection	recollections
reconnaissance	reconnaissances
recover	recoverable	irrecoverable	recovered	recovering	recovers	recovery
recreation	recreations	recreational
recur	recurring	recurred	recurs	recurrent	recurrence	recurrences
red	redder	reddest	redness	redden	reddened	reddening	reddens	reddish	reddy	reds
reel	reels	reeled	reeling	unreel	unreels	unreeled	unreeling
refer	refers	referring	referred	referral	referrals	referent	referents	reference	references	referential
referee	refereed	refereeing	referees
reflect	reflects	reflecting	unreflecting	reflected	reflective	reflectively	reflectiveness	reflection	reflections	reflectance
reflex	reflexes	reflexive
refund	refunded	refunding	refunds
refuse	refusal	refusals	refused	refuses	refusing
regard	disregard	disregarded	disregarding	disregards	regarded	regarding	regardless	regards
register	registered	registering	registers	registration	unregistered
regret	regretting	regretful	regretted	regrets	regrettable	regrettably	regretfully
regular	regulars	irregular	regularly	regularity	irregularly	irregularity	irregularities
regulate	regulated	regulates	regulating	regulation	regulations	regulator	regulators	regulatory	unregulated
rehearse	rehearses	rehearsed	rehearsing	rehearsal	rehearsals
rein	reins
reiterate	reiterates	reiterated	reiterating	reiteration	reiterations
rekindle	rekindles	rekindled	rekindling
relation	relate	related	relates	relating	relations	relationship	relationships	unrelated	relational
relax	relaxation	relaxed	relaxes	relaxing
release	released	releases	releasing
relentless	relentlessness	relentlessly
relevant	irrelevance	irrelevant	relevance
relief
relieve	relieving	relieves	relieved
religion	religions	religious	religiously
relish	relishes	relished	relishing
reluctance	reluctant	reluctantly
rely	reliability	unreliability	reliable	reliably	reliance	reliant	relied	relies	relying	unreliable
remain	remained	remaining	remains	remainder	remainders
remark	remarked	remarking	remarks	remarkable	remarkably	unremarkable	unremarkably
remedy	remedies	remedied	remedying	remedial	remedially
remember	remembered	remembering	remembers	remembrance
remind	reminds	reminding	reminded	reminder	reminders
remorse	remorses	remorseless	remorselessness	remorselessly	remorseful	remorsefully
remove	removable	removal	removals	removed	removes	removing	remover	removers
rename	renames	renamed	renaming
repeat	repeated	repeatedly	repeating	repeats	repeater	repeaters	repetition	repetitions	repetitious
repent	repents	repented	repenting	repentance	repentances	repentant	repentants	repentantly	unrepentant
replace	replacing	replaces	replaced	replacement	replacements	replaceable	irreplaceable
reply	replied	replies	replying
report	reported	unreported	reportedly	reporter	reporters	reporting	reports
represent	representative	representatives	rep	reps	represented	unrepresented	representing	represents	representation	representations	representational	unrepresentative	representativeness
reprieve	reprieves	reprieval
reproach	reproaches	reproachful	reproachfully
reprobate	reprobates
reproduce	reproduces	reproducing	reproduced	reproduction	reproductions	reproducible
reproof
reputation	reputations
repute	reputes	reputed	reputedly	reputing
request	requests	requesting	requested
require	required	requirement	requirements	requires	requiring
research	researched	researcher	researchers	researches	researching
resemble	resembled	resembling	resembles	resemblance	resemblances
resent	resented	resenting	resents	resentment	resentments	resentful	resentfulness	resentfully
reserve	reserves	reservation	reservations	reserved	reserving	unreserved	unreservedly	reservist	reservists
resign	resigns	resigning	resigned	resignedly	resignation	resignations
resist	resists	resisting	resisted	resistible	resistance	resistances	resistant	unresistant	nonresistant	resistor	resistors
resolution	resolutions
resolve	resolved	resolves	resolving	unresolved
respect	respected	respecting	respects	respectful	respectable	respectfully
respective	respectively	irrespective	irrespectively
respite	respites
rest	rested	resting	restful	restfully	restfulness	restless	restlessly	restlessness	rests
restive	restiveness	restively
restrain	restrained	restraining	restrains	restraint	restraints	unrestrained
restrict	restricted	restricting	restriction	restrictions	restrictive	restrictively	restricts	unrestricted	unrestrictive
result	resulted	resulting	results	resultant
retrace	retraces	retraced	retracing
retreat	retreats	retreated	retreating
retribution	retributions
return	returned	unreturned	returning	returns	returner	returners	returnee	returnees	returnable
reveal	revealed	unrevealed	revealing	reveals	revelation	revelations
revenge	revenges
revenue	revenues
revere	reveres	revered	revering	reverence	reverences	reverent	reverently	reverential	reverentially
reverend	reverends	revd	rev
reverse	reversal	reversed	reverses	reversible	reversing	reversals	irreversible
review	reviews	reviewed	reviewing	reviewer	reviewers
revolt	revolted	revolting	revolts
reward	rewarded	unrewarded	unrewarding	rewarding	rewards
rhythm	rhythms	rhythmic	rhythmical	rhythmically
ribbon	ribbons
rich	richer	richest	richly	richness	riches
rickety	ricketier	ricketiest
riddle	riddles	riddled	riddling
ride	ridden	rider	riders	rides	riding	rode
ridge	ridges	ridging	ridged
ridicule	ridicules	ridiculed	ridiculing
rig	rigging	rigged	rigs	rigger	riggers
right	rightful	rightfully	rightist	rightists	rightly	rights	rightness	rt
righteous	righteousness	unrighteous	unrighteousness	righteously
rigid	rigidities	rigidity	rigidly
rim	rimmed	rims	rimless
ring	rang	ringed	ringing	rings	rung
ringside	ringsides
rip	ripped	ripping	rips
ripe	riper	ripest	ripeness	unripe	ripely	ripen	ripens	ripened	unripened	ripening
ripple	rippled	ripples	rippling
rise	rises	rising	rose	risen	riser	risers
risk	risks	risking	risked	risky	riskiness
rival	rivals	rivalling	rivalled	unrivalled	rivalry	rivalries
river	rivers	riverside
road	roads	roadside	rd
roam	roams	roamed	roaming	roamer	roamers
roar	roars	roared	roaring	roarer	roarers
rob	robs	robbing	robber	robbed	robbers	robbery	robberies
robe	robes
rock	rocks	rocky	rocked	rocking	rocker	rockers
rod	rods
roger	rogers	rogered	rogering
roll	rolled	rolling	rolls	roller	rollers	unroll	unrolled	unrolling	unrolls
rome	roman	romans
roof	roofs	roofing	roofed	rooftop	rooftops
room	rooms	classroom	classrooms	roomy	roomier	roomiest
rope	ropes	roping	roped
roses	rosy	rosier	rosiest	rosiness	rosily
rot	rotting	rotted	rots	rotten	rotten	rottener	rottenest	rottenness	rottenly
rote
rotund	rotundly	rotundness	rotundity
rough	roughly	roughness	rougher	roughest
round	rounded	rounding	rounder	roundest	roundly	roundness	rounds	rounders
route	routed	routes	routing
row	rows	rowing	rowed	rower	rowers
royal	royals	royalty	royalties	royally
rub	rubs	rubbing	rubbed
rubber	rubbers	rubbery
rude	rudeness	rudely	ruder	rudest
ruffle	ruffles	ruffled	unruffled	ruffling
ruin	ruins	ruinous	ruinously	ruined	ruining	ruination
rule	ruled	unruled	ruler	rulers	rules	ruling	rulings
ruminate	ruminates	ruminated	ruminating	rumination	ruminations
rumour	rumoured	rumours	rumor	rumors	rumored	rumoring	rumouring
rumple	rumples	rumpling	rumpled
run	ran	runner	runners	running	runs	runny	runnier	runniest
rural
rush	rushed	rushes	rushing
rust	rustier	rustiest	rustiness	rusty	rusting	rusted	rusts
rustle	rustles	rustled	rustling
rut	ruts	rutted	rutting
ruthless	ruthlessness	ruthlessly
sacred	sacredness
sacrifice	sacrificing	sacrifices	sacrificed	sacrificial
sad	sadness	sadly	saddest	sadder	sadden	saddened	saddening	saddens
safe	safely	safeness	safer	safest	safety	unsafe
saffron	saffrons
sag	sagging	sagged	sags	saggy
sage	sages	sagely
sake	sakes
salary	salaried	salaries
salt	salty	salted	unsalted	salts	salting
salute	salutes	saluted	saluting	salutation
salve	salves	salved	salving
same	sameness
sane	saneness	sanely	sanity	sanities	insane	insanely	insanity	insanities
sapling	saplings
sarcasm	sarcasms
sarcastic	sarcastically
satan	satans	satanic	satanically	satanism
satin	satins	satiny
satire	satires	satiric	satirical	satirically	satirist	satirists
satisfy	satisfying	satisfies	satisfied	satisfactory	satisfaction	satisfactorily	unsatisfied	unsatisfying	unsatisfactory	unsatisfactorily
saturday	saturdays
savage	savageness	savagely	savagery	savagest	savager	savaged	savages	savaging
save	saved	unsaved	saves	saving	savings	saver	savers
savour	savours	savoured	savouring	savor	savors	savored	savoring
say	said	unsaid	saying	sayings	says
scale	scaled	scales	scaling	scalings	scalable
scan	scanned	scanning	scans	scanner	scanners
scant	scanter	scantest	scantness	scantly
scanty	scantier	scantiest	scantiness	scantily
scar	scarred	scarring	scars
scarce	scarceness	scarcely	scarcity	scarcities	scarcer	scarcest
scare	scares	scared	scaring	scareder	scaredest	scary	scarier	scariest
scarlet
scathing	scathingly
scatter	scatters	scattering	scattered
scene	scenery	scenes	scenic	scenically
scent	scented	unscented	scents	scentless	scenting
sceptic	sceptics	sceptical	scepticism	sceptically	skeptical	skeptically	scepticisms	skepticism	skepticisms
schedule	scheduled	scheduling	schedules	sch	unscheduled	nonscheduled	reschedule	rescheduled	rescheduling	reschedules
school	schooling	schools	schooled	preschool	preschools	preschooling	preschooled	preschooler	preschoolers
schoolboy	schoolboys
science	sciences	scientific	scientist	scientists	scientifically	unscientifically	unscientific
scissors
scoff	scoffs	scoffed	scoffing	scoffer	scoffers
scorch	scorches	scorched	scorching	scorcher	scorchers
score	scored	scoring	scores	scorer	scorers
scorn	scorned	scorner	scorners	scorning	scorns	scornful	scornfully
scowl	scowls	scowled	scowling
scrap	scrapped	scrapping	scraps
scrape	scrapes	scraped	scraping	scraper	scrapers
scratch	scratching	scratches	scratched	unscratched	scratchy	scratchiness
scrawl	scrawls	scrawled	scrawling
scream	screamed	screaming	screams
scribble	scribbles	scribbled	scribbling	scribbler	scribblers
script	scripts	unscripted
scrub	scrubbing	scrubbed	scrubs
scruple	scruples
scrupulous	scrupulousness	unscrupulous	unscrupulousness	unscrupulously	scrupulously
scrutiny	scrutinize	scrutinized	scrutinizes	scrutinizing
scurry	scurries	scurried	scurrying
scuttle	scuttles	scuttled	scuttling
scythe	scythed	scything	scythes
sea	seaman	seaside	seamen	seas
sear	seared	searing	sears	searingly
search	searching	searches	searched	searcher	searchers
seat	seated	seating	seats	seater	seaters	unseated	unseats	unseating	unseat
second	secondary	secondarily	secondly	seconder	seconders	secondee	seconds	sec	secs	seconded	seconding	secondment	secondments	
secret	secrecy	secretly	secrets	secretive	secretiveness	secretively
section	sectional	sectioned	sectioning	sections	subsection	subsections
secure	insecure	insecurities	insecurity	secured	securely	secures	securing	securities	security	unsecured
see	saw	seeing	unseeing	seen	sees	unseen	seer	seers
seed	seeds	seeding	seeded	seedling	seedlings
seek	seeking	seeks	sought	unsought	seeker	seekers
seem	seemed	seeming	seemingly	seems
seep	seeps	seeped	seeping	seepage	seepages
seize	seized	seizes	seizing
seldom
select	selected	selecting	selection	selections	selective	selectively	selector	selectors	selects	selectivity	selectivities
self	selfishness	selfishly	selfish	selves	selfless	selflessness	selflessly	unselfish	unselfishness	unselfishly
sell	seller	sellers	selling	sells	sold	unsold	resell	reselling	resold	reseller	resellers
semblance	semblances
semi
send	sender	senders	sending	sends	sent	unsent
sensation	sensations	sensational	sensationally	sensationalism	sensationalist	sensationalists	sensationalize	sensationalizes	sensationalized	sensationalizing	sensationalise	sensationalises	sensationalised	sensationalising
sense	senseless	senselessness	senses	sensing	sensings	sensed
sensitive	sensitivity	sensitivities	insensitivity	insensitive	sensitively
sentence	sentences
sentiment	sentimental	unsentimental	sentimentalist	sentimentally	sentiments	sentimentality	sentimentalities
sentinel	sentinels
separate	separated	separately	separates	separating	separation	separations	separatist	separatists	inseparable	separateness	separatenesses	separatism	separable	separably	inseparably
sequence	sequenced	sequences	sequencing	sequential	sequentially
serene	sereneness	serenely	serenity	serenities
series
serious	seriously	seriousness
serve	servant	servants	served	unserved	serves	serving	servings	server	servers	servery
service	services	serviced	unserviced	servicing
session	sessions
set	sets	setting	settings	unset
settle	settled	settlement	settlements	settler	settlers	settles	settling	settlor	settlors	resettle	resettled	resettlement	resettlements	resettler	resettlers	resettles	resettling
seven	seventeen	seventeenth	seventh	seventies	seventieth	seventy
several
severe	severity	severest	severer	severeness	severely
shabby	shabbily	shabbiness
shade	shaded	shading	shadings	shady	shadiness	shades
shadow	shadowed	shadowing	shadows	shadowy
shaft	shafts
shake	shaken	shakes	shakily	shaking	shaky	shook	unshakeable	shaker	shakers
shall	shan	shalt
shallow	shallowness	shallowest	shallower	shallowly
shamble	shambles	shambled	shambling
shame	shaming	shames	shameful	shamefully	shamed	shameless	shamelessly
shape	shaped	shapes	shaping	shapeless	shapely	shapelier	shapeliest	shapeliness	unshapely	misshape	misshapen	misshapes	misshaping	misshaped
share	shared	unshared	shares	sharing
sharp	sharpness	sharply	sharpest	sharper	sharpens	sharpening	sharpened	sharpen	sharpener	sharpeners
shatter	shatters	shattered	shattering
shave	shaves	shaved	shaving	shaver	shavers	shaven	unshaven
she	her	hers	herself
shear	shears	sheared	shearing	shearer	shearers
sheathe	sheathes	sheathed	sheathing	unsheathe	unsheathes	unsheathed	unsheathing
shed	shedding	sheds
sheen	sheens	sheeny	sheenier	sheeniest
sheepish	sheepishness	sheepishly
sheer	sheerness
sheet	sheets	sheeting	sheetings
shelf	shelves	shelve	shelved	shelving
shelter	shelters	sheltering	sheltered	unsheltered
shepherd	shepherds	shepherdess	shepherdesses
shift	shifted	shifting	shifts
shifty	shiftier	shiftiest	shiftiness	shiftily
shimmer	shimmered	shimmers	shimmering
shine	shined	shines	shining	shone	shiny
shingle	shingles
shirt	shirts
shiver	shivers	shivered	shivering
shock	shocks	shocking	shocked	shockingly	shocker	shockers
shoe	shoed	shoeing	shoes	shoeless
shoot	shooting	shootings	shoots	shot	shots	shooter	shooters
shop	shops	shopping	shoppers	shopper	shopped
short	shortage	shortages	shorten	shortened	shortening	shortens	shorter	shortest	shortly	shortness
shortcoming	shortcomings
should	shouldn
shoulder	shouldered	shouldering	shoulders
shout	shouted	shouting	shouts
shove	shoves	shoved	shoving
show	showed	showing	shown	shows
shower	showers	showering	showered
shred	shredded	shredding	shreds	unshredded
shrewd	shrewder	shrewdest	shrewdness	shrewdly
shriek	shrieks	shrieked	shrieking
shrill	shriller	shrillest	shrillness	shrilly	shrilling	shrilled
shrimp	shrimps
shrink	shrank	shrunk	shrunken	shrinks	shrinking	shrinkable	shrinkage	shrinkages
shrivel	shrivels	shriveled	shriveling
shrub	shrubs	shrubbery	shrubberies	shrubby
shrug	shrugging	shrugged	shrugs
shudder	shudders	shuddered	shuddering
shuffle	shuffles	shuffled	shuffling	shuffler	shufflers
shut	shutting	shuts
shutter	shuttered	shutters
shy	shyly	shyness
sick	sickness	sickly	sickest	sicker	sicken	sickened	sickens	sickening	sickeningly
side	sides	sided	siding
sidewalk	sidewalks
sideways
sigh	sighs	sighed	sighing
sight	sights	unsightly	sighted	unsighted	sighting	sightings
sign	signed	signing	signs	unsigned	signer	signers
signal	signals	signalling	signalled	signaling	signalman
significant	insignificant	insignificantly	significance	significantly	insignificance	insignificances
silence	silenced	unsilenced	silences	silencing	silent	silently	silencer	silencers
silhouette	silhouetted	silhouettes	silhouetting
silk	silks	silky	silkiness	silkier	silkiest	silkily	silken
sill	sills
silver	silvery
similar	dissimilar	similarities	dissimilarity	dissimilarities	similarity	similarly
simple	simpleness	simpler	simplest	simplicity	simplification	simplified	simplify	simplifies	simplifying	simply	simplistic	simplistically
simulate	simulates	simulated	simulating	simulation	simulations	simulator	simulators
since
sinew	sinews	sinewy
sing	sings	sang	sung	unsung	singer	singers	singing
single	singled	singly	singleness	singling	singles
sinister	sinisterly
sink	sunk	sinks	sinking	sank	sunken	sinker	sinkers
sir
sit	sat	sits	sitting	sittings	sitter	sitters
site	sited	siting	sites
situate	situation	situational	situationally	situations	situated	situating
six	sixes	sixteen	sixteenth	sixteenths	sixth	sixthly	sixths	sixties	sixtieth	sixtieths	sixty
size	sizes	sizing	sized	sizable
sizzle	sizzled	sizzles	sizzling	sizzler	sizzlers
skeleton	skeletons
sketch	sketched	sketches	sketching
skid	skidding	skidded	skids
skin	skins	skinning	skinned
skip	skipping	skipped	skips
skirt	skirts	skirted	skirting
skull	skulls
sky	skies
skyline	skylines
slab	slabs
slack	slacker	slackers	slacken	slackened	slackening	slackens	slackly
slam	slamming	slammed	slams
slant	slants	slanted	slanting
slap	slapping	slapped	slaps
slate	slated	slating	slates
slaughter	slaughters	slaughtered	slaughtering	slaughterer	slaughterers
sledge	sledging	sledged	sledges
sleek	sleeker	sleekest	sleekness	sleekly
sleep	sleeping	sleeps	sleepy	sleepiness	slept	sleepless	sleeper	sleepers	sleepily
sleeve	sleeves	sleeveless
slender	slenderer	slenderest	slenderness	slenderize	slenderizes	slenderized	slenderizing
slick	slicker	slickest	slickness	slickly
slide	slid	slides	sliding
slight	slighter	slightest	slighting	slights	slighted	slightly
slim	slimmed	slims	slimming	slimmings	slimmer	slimmers	slimmest	slimly	slimness
sling	slung	slings	slinging
slip	slips	slipping	slipped	slippage	slippages
slipper	slippers
slit	slits	slitting
slop	slops	slopped	slopping	sloppy	sloppiness	sloppier	sloppiest	sloppily
slope	sloping	slopes	sloped
slouch	slouches	slouched	slouching	sloucher	slouchers
slow	slowed	slower	slowest	slowing	slowly	slowness	slows
slug	slugs
slump	slumps	slumped	slumping
slur	slurred	slurring	slurrer	slurrers	slurs
smack	smacks	smacked	smacking	smacker	smackers
small	smaller	smallest	smallness	smallish
smash	smashed	unsmashed	smashes	smashing
smile	smiled	smiles	smiling	unsmiling
smite	smote	smites	smiting	smitten
smoke	smoked	smokes	smoking	smokeless	smoker	smokers	smokefree	nonsmoking	smoky	smokier	smokiest	smokiness	smokey
smooth	smooths	smoothly	smoothing	smoothed	smoothness	smoothnesses	smoother	smoothest
smother	smothers	smothered	smothering
smoulder	smoulders	smouldered	smouldering
snake	snaked	snaking	snakes
snap	snapped	snaps	snapping	snapper	snappers
snare	snares	snared	snaring	ensnare	ensnares	ensnared	ensnaring	ensnarement	ensnarements
snarl	snarls	snarled	snarling	unsnarl	unsnarls	unsnarled	unsnarling
snatch	snatched	snatches	snatching
sneak	sneaks	sneaked	sneaking	sneaker	sneakers	sneaky	sneakiness	sneakily
sneer	sneers	sneered	sneering	sneeringly
sneeze	sneezes	sneezed	sneezing
snort	snorts	snorted	snorting	snorter	snorters
snow	snows	snowed	snowing	snowy	snowier	snowiest	snowiness
snowfall	snowfalls
snuggle	snuggles	snuggled	snuggling
so
soak	soaks	soaked	soaking
sob	sobbing	sobbed	sobs
sober	soberer	soberest	soberness	soberly	sobering	sobers	sobered
sobriquet	sobriquets
society	societies	societal
socket	sockets
sodden	soddenly
soft	soften	softened	softening	softens	softer	softest	softly	softness
soil	soils	soiled	soiling	unsoiled
sole	solely	soles
solemn	solemner	solemnest	solemnness	solemnly	solemnity	solemnities	solemnize	solemnizes	solemnized	solemnizing	solemnization	solemnise	solemnises	solemnised	solemnising
solicit	solicits	solicited	soliciting	solicitation	unsolicited	solicitous	solicitousness	solicitously
solid	solidify	solidified	solidifies	solidifying	solidly	solids	solidity	solidities
solitary	solitarily	solitariness
solitude	solitudes
solution	solutions
some	somebody	somehow	someone	something	somethin	sometime	sometimes	somewhere
son	sons	sonny
song	songs
soon	sooner	soonest
soothe	soothes	soothed	soothing	soothingly	soother	soothers
sophist	sophists	sophistry	sophism
sophistication	sophistications
sore	soreness	sorely	sores	sorer	sorest
sorrow	sorrowing	sorrows	sorrowful	sorrowfulness	sorrowfully
sorry	sorriness	sorriest	sorrier
sort	sorted	unsorted	sorting	sorts
soul	souls	soulful	soulfully	soulless	soullessly
sound	sounds	sounded	sounding	soundless	soundlessly
south	southward	southwards	southerly	southerlies	southbound	southern	southerner	southerners	southernmost
souvenir	souvenirs
space	spaced	unspaced	spaces	spacing	spacious	spaciousness	spaciously
span	spanned	spanning	spans
spangle	spangled	spangling
spare	sparing	spares	spared	sparingly
spasm	spasms
spasmodic	spasmodically
speak	speaker	speakers	speaking	speaks	spoke	spoken	unspoken	unspeaking	unspeakable
special	specials	specially	specialist	speciality	specialty	specialities	specialists	specialize	specialization	specialized	specializations	specialise	specialises	specialised	specialising	specialisation	specializes	specializing	specialism	specialisms
specific	specifically	specification	specifications	specificity	specifics
specify	specifiable	specified	specifies	specifying	unspecified
specimen	specimens
spectacular	spectacularly
speech	speeches	speechless
speed	sped	speeded	speeding	speeds	speedy	speedily	highspeed
spell	spelt	spells	spelling	spellings	spelled	misspelt
spend	spending	spends	spent	unspent	spender	spenders
spendthrift	spendthrifts
spice	spiced	spices	spicing	spicy	spicier	spiciest	spiciness	spicily
spike	spiked	spikes	spiking	spiky	spikier	spikiest	spikiness	spikey
spill	spills	spilling	spilled	spilt	unspilt	spillage	spillages
spin	spun	spins	spinning
spine	spines	spineless	spinelessness	spinelessly	spinal	spinally	spiny
spirit	spirits	spiritual	spiritually	spirituality
spite	spiteful	spitefulness	spitefully
splash	splashes	splashed	splashing
spleen	spleens
splendid	splendidly
splendour	splendours	splendor	splendors
splinter	splinters	splintering	splintered	splintery
split	splitting	splits
splotch	splotches	splotched	splotchin
spoil	spoils	spoiling	spoiled	spoilt	unspoilt	unspoiled
sponge	sponges	sponging	sponged	spongy	sponginess
spontaneous	spontaneously	spontaneity
sport	sporting	sports	sporty
spot	spots	spotted	spotting	spotless	spotlessness	spotlessly	spotty	spottier	spottiest	spottiness	spottily	spotter	spotters
spotlight	spotlights
sprawl	sprawls	sprawled	sprawling
spread	spreading	spreads
spring	sprang	springing	springs	sprung
springy	springier	springiest	springiness	springily
spur	spurs	spurring	spurred
spurious	spuriousness	spuriously
squad	squads
squander	squanders	squandered	squandering
square	squarely	squareness	squarer	squares	squarest	squared	squaring	sq
squash	squashed	squashing	squashes	squashy	squashier	squashiest
squat	squatting	squatted	squatter	squatters	squats
squeak	squeaks	squeaked	squeaking	squeaker	squeakers	squeaky	squeakiest	squeakier
squeal	squeals	squealed	squealing	squealer	squealers
squint	squints	squinted	squinting	squinty	squinter	squinters
squirm	squirms	squirmed	squirming
stable	instability	stabilisation	stabilise	stabilised	stabilises	stabilising	stabilization	stabilize	stabilized	stabilizes	stabilizing	stability	unstable	stabiliser	stabilisers	stabilizer	stabilizers
staccato
stack	stacks	stacked	unstacked	stacking
staff	staffed	staffing	staffs	staffer	staffers
stage	staging	staged	stages
stagger	staggers	staggered	staggering
stagnate	stagnated	stagnates	stagnating	stagnation	stagnations
stain	stains	stained	staining	stainless
stairs	stair	upstairs	downstairs
stale	staleness
stall	stalls	stalled	stalling
stammer	stammers	stammered	stammering	stammerer	stammerers
stamp	stamps	stamping	stamped	unstamped
stampede	stampedes
stand	standing	stands	stood
standard	standards	standardise	standardised	unstandardised	standardising	standardisation	standardize	standardized	unstandardized	standardizing	standardization	substandard
standstill	standstills
star	starred	stars	starring	stardom	starry
stare	stared	stares	staring
stark	starker	starkest	starkness	starkly
start	started	starting	starts	starter	starters	restart	restarts	restarted	restarting
startle	startles	startled	startling	startlingly
starve	starves	starved	starving	starvation
state	stated	unstated	statement	statements	stating	states
states	interstate
station	stations	stationed	stationing
statue	statues	statuary	statuaries	statuesque	statuette	statuettes
status
stay	stayed	staying	stays	stayer
steady	unsteady	unsteadily	steadying	steadily	steadies	steadied	steadier	steadiest	steadiness
stealth	stealths	stealthy	stealthier	stealthiest	stealthiness	stealthily
steam	steaming	steams	steamed	steamy
steel	steely
steeple	steeples
step	stepped	stepping	steps
stern	sterner	sternest	sternness	sternly
stetson	stetsons
stick	sticking	sticks	stuck	unstuck	sticker	stickers	sticky	stickier	stickiest	stickiness	stickily
stiff	stiffly	stiffness	stiffest	stiffer	stiffens	stiffening	stiffened	stiffen
stifle	stifles	stifled	stifling
still	stiller	stillest	stillness	stills	stilled	stilling
sting	stung	stings	stinging	stinger	stingers
stir	stirs	stirring	stirred
stock	stocks	stocked
stocking	stockings
stolid	stolider	stolidest	stolidness	stolidly	stolidity	stolidities
stomach	stomachs
stone	stoned	stones	stoning	stony
stool	stools
stoop	stoops	stooped	stooping
stop	stopped	stopping	stops	unstoppable	stoppage	stoppages	stopper	stoppers
store	stored	stores	storing	storage
storm	stormed	storming	storms
stormy	stormier	stormiest	storminess	stormily
story	stories
stove	stoves
straggle	straggles	straggled	straggling	straggler	stragglers
straight	straighten	straightener	straighteners	straightened	unstraightened	straightening	straightens	straighter	straightest
strain	strained	straining	strains
strange	strangely	strangeness	stranger	strangers	strangest
straw	straws
streak	streaked	streaking	streaks	streaky	streakier	streakiest
stream	streamed	streaming	streams
street	streets	st
strength	strengthen	strengthened	strengthening	strengthens	strengths
stretch	stretched	unstretched	stretches	stretching	stretchy	stretchiness
strew	strews	strewn	strewing
stricken
strict	strictness	strictly	strictest	stricter
stride	strode	strides	striding
strident	stridently
strike	strikes	striking	strikingly	struck	striker	strikers
string	strings	stringing	strung	stringy
strip	strips	stripped	stripping	stripper	strippers
stripling	striplings
stroke	strokes	stroked	stroking	strokings
strong	stronger	strongest	strongly
struggle	struggled	struggles	struggling
stub	stubs	stubby
stubborn	stubborner	stubbornest	stubbornness	stubbornly
study	studied	studies	studying	studious	studiously
stuff	stuffs	stuffing	stuffed
stumble	stumbles	stumbled	stumbling	stumbler	stumblers
stun	stunned	stuns	stunning	stunningly
stupendous	stupendously
stupid	stupidity	stupidly	stupidest	stupider
style	styled	styles	styling	stylish	stylise	stylised	stylises	stylising	stylize	stylized	stylizes	stylizing	stylist	stylists	stylistic	stylistically	stylistics
suave	suaveness	suavely	suavity	suavities
subconscious	subconsciousness	subconsciously
subject	subjected	subjecting	subjects	subjection	subjections
subscribe	subscribes	subscribed	subscribing	subscriber	subscribers	subscription	subscriptions
subside	subsides	subsided	subsiding	subsidence	subsidences
succeed	succeeded	succeeding	succeeds	success	successes	successful	successfully	unsuccessful	unsuccessfully
succession	successions	successive	successively	successor	successors
succinct	succincter	succinctest	succinctness	succinctly
succumb	succumbs	succumbed	succumbing
such
suck	sucks	sucking	sucked
sudden	suddenly	suddenness
suffer	suffered	suffering	sufferings	suffers	sufferer	sufferers
sufficient	sufficiency	insufficiency	insufficient	insufficiently	sufficiently
suggest	suggested	suggesting	suggestion	suggestions	suggests	suggestive	suggestiveness	suggestively
suit	suits	suiting	suited	suitability	suitable	suitably	unsuited	unsuitable
sulk	sulks	sulked	sulking	sulky	sulkiness	sulkily
sullen	sullener	sullenest	sullenness	sullenly
sum	summation	summed	summing	sums
summer	summers	midsummer	summery	summered	summering
summon	summoned	summoning	summons
sun	sunlight	sunny	suns	sunshine	sunned	sunning
sunday	sundays
sunlit
sup	supping	supped	sups
superb	superbly
superficial	superficially	superficiality	superficialities
superior	superiority	superiors
superstition	superstitions
supper	suppers
supplement	supplementary	supplemented	supplementing	supplements	supplementation	supplemental
supplicate	supplicates	supplicating	supplicated	supplication	supplications	supplicatory
support	supported	supporter	supporters	supporting	supports	supportive	unsupported
suppose	supposed	supposedly	supposes	supposing
suppress	suppressed	suppresses	suppressing	suppression	suppressor	suppressors
supreme	supremely
sure	surely	sureness	surer	surest	unsure
surface	surfaced	surfaces	surfacing
surge	surges	surged	surging
surprise	surprised	surprises	surprising	surprisingly	unsurprising	unsurprised	unsurprisingly
surrender	surrendered	surrendering	surrenders
surround	surrounded	surrounding	surrounds	surroundings
survey	surveyed	unsurveyed	surveying	surveys	surveyor	surveyors
survive	survival	survived	survives	surviving	survivor	survivors
suspect	suspects	suspecting	suspected	unsuspected	unsuspecting
suspense	suspenses	suspenseful
suspicion	suspicions
suspicious	suspiciously
sustain	sustained	sustaining	sustains	sustainable	unsustainable	sustainability
swallow	swallows	swallowing	swallowed
swamp	swamps	swamped	swamping	swampy
swarm	swarms	swarmed	swarming
swarthy	swarthier	swarthiest
sway	sways	swayed	swaying
swear	sworn	swore	swears	swearing
sweat	sweats	sweaty	sweatier	sweatiest	sweated	sweating
sweep	swept	sweeps	sweeping	sweeper	sweepers
sweet	sweeter	sweetest	sweetness	sweetly	sweets	sweeten	sweetens	sweetened	sweetening	sweetener	sweeteners	unsweetened	sweetie	sweeties
swell	swollen	swells	swelling	swelled
swift	swiftly	swiftness
swim	swum	swims	swimming	swam	swimmer	swimmers
swing	swung	swings	swinging
swirl	swirls	swirled	swirling
swish	swishes	swished	swishing	swisher
syllable	syllables	syllabic	syll	sylls
sympathy	sympathies	sympathetic	unsympathetic	unsympathetically	sympathetically
symphony	symphonies	symphonic
synonym	synonyms	synonymy	synonymous
system	systematic	unsystematic	unsystematically	systems	systematically	subsystem	subsystems
table	tablecloth	tables	tabled	tabling
tableau	tableaus
tacit	tacitness	tacitly
tack	tacks	tacked	tacking
tackle	tackled	tackles	tackling
tad	tads
tail	tails	tailed	tailing	tailings
take	taken	takes	taking	takings	took	taker	takers
takin	takins
tale	tales
talent	talented	untalented	talents
talk	talked	talking	talks	talker	talkers	talkative	
tall	tallest	taller	tallness
tan	tanned	tanning	tans
tangible	tangibleness	intangible	intangibles	tangibly	intangibly
tangle	tangles	entangle	entangles	entangled	entangling	entanglement	entanglements	tangled	tangling	untangled
tantalise	tantalised	tantalises	tantalising	tantalisingly	tantalize	tantalized	tantalizes	tantalizing	tantalizingly
tap	taps	tapping	tapped	untapped
tar	tarred	tarring	tars
tardy	tardier	tardiest	tardiness
task	tasks
taste	tasted	tastes	tasting	tasty	tastier	tastiest	tasteful	tastefulness	tastefully	tasteless	tastelessness	tastelessly	taster	tasters
tatter	tattered	tatters
taut	tauter	tautest	tautness	tautly	tauten	tautens	tautened	tautening
tavern	taverns
tax	taxes	taxed	taxing	taxpayer	taxpayers	taxation	taxable	nontaxable	untaxed
teach	taught	teacher	teachers	teaches	teaching	teachings
team	teamed	teaming	teams
tear	tearing	tears	tore	torn
tease	teases	teased	teasing	teasingly	teaser	teasers
technical	technically
tell	retell	retelling	telling	tells	told	untold
temerity	temerities
temper	tempers
temperament	temperaments	temperamental	temperamentally
temple	temples
temporary	temporarily	temp	temps
tempt	tempts	tempting	tempted	temptation	temptations
ten	tens	tenth	tenths
tender	tenderness	tenderly
tense	tensed	tenses	tensing	tension	tensely	tenser	tensest	tensions
tentative	tentativeness	tentatively
term	terms	termed	terming
terrible	terribly
terrific	terrifically
terrify	terrifies	terrified	terrifying	terrifyingly
terror	terrors	terrorist	terrorists	terrorism	terrorise	terrorised	terrorising	terrorize	terrorized	terrorizing
terse	terseness	tersely
than
thank	thanks	thanking	thankfully	thankful	thankless	thanked
thaw	thaws	thawed	thawing
the
theatre	theatres	theater	theaters	theatrical	theatrically
theft	thefts
theme	themes	thematic	thematically
then
there
thereabouts
therefrom
they	their	theirs	them	em	themselves
thick	thickness	thicknesses	thickly	thickest	thicker	thicken	thickens	thickened	thickening	thickener	thickeners
thicket	thickets	throe
thigh	thighs
thin	thins	thinning	thinnest	thinness	thinner	thinned	thinly
thing	things	thingy	thingies
think	thinking	unthinkable	thinks	thought	thoughts	thoughtful	thoughtfully	thoughtfulness	unthought	unthinking	unthinkingly	thoughtless	thoughtlessly	thoughtlessness	thinker	thinkers	rethink	rethought	rethinks	rethinking
thirty	thirties	thirtieth	thirtieths
this	these	those	that
thorn	thorns	thorny	thornier	thorniest	thorniness
thorough	thoroughness	thoroughly
thoroughfare	thoroughfares
thou	thee	thine	thy	thyself	tha	thi
though	tho
thousand	thousands	thousandth	thousandths
thread	threads	threading	threaded
threat	threats	threatens	threatening	threateningly	threatened	threaten
three	threes	third	thirdly	thirds
threshold	thresholds
thrift	thrifts	thriftless	thrifty	thriftier	thriftiest	thriftiness	thriftily
thrill	thrilled	thrilling	thrills	thriller	thrillers
throat	throats	throaty
throb	throbs	throbbed	throbbing
throne	thrones
throng	throngs	thronged	thronging
through	throughout
throw	threw	throwing	thrown	throws	thrower	throwers
thrust	thrusts	thrusted	thrusting	thrustings
thud	thudded	thudding	thuds
thumb	thumbs	thumbed	thumbing	thumbings
thump	thumps	thumped	thumping
thunder	thundered	thundering	thunders	thundery	thunderous	thunderously
thus
tick	ticks	ticked	ticking	ticker	tickers
ticket	tickets
tide	tides	tidal
tiding	tidings
tidy	tidier	tidiest	tidiness	untidy	untidier	untidiest	untidiness	untidily	tidily	tidied	tidying	tidies
tie	untied	untie	tying	ties	tied	unties	untying
tight	tighter	tightest	tightly	tightness	tightens	tightening	tightened	tighten	tights
tilt	tilts	tilted	tilting
timber	timbered	timbers
time	timer	times	timeless	timely	timing	timed	untimed
timid	timider	timidest	timidness	timidly	timidity	timidities
tinge	tinges	tinged	tinging
tingle	tingles	tingled	tingling
tinkle	tinkles	tinkled	tinkling
tinsel	tinsels	tinselling
tint	tints	tinted	tinting
tiny	tinier	tiniest	tininess	teeny	
tip	tips	tipping	tipped
tiptoe	tiptoeing	tiptoes	tiptoed
tirade	tirades
tire	tiring	tires	tired	tiredly	tiredness	tireless	tirelessness	tirelessly
tit	tits
title	titled	titles	titling	untitled
to
today
toe	toes
together	togetherness
togs	togged	togging
toil	toiled	toiling	toils	toiler	toilers
tolerate	tolerated	tolerates	tolerating	toleration	tolerance	tolerances	tolerant	tolerantly	intolerant	intolerantly	intolerance	intolerances
toll	tolls
tombstone	tombstones
tomorrow	tomorrows
tone	tones	tonal	tonality	toned	toning	toner	toners
tongue	tongues
tonight
too
tooth	teeth	toothless	toothy	teething	teethed	teethes	teethings	toothed
top	topped	untopped	topping	tops	topless
topic	topical	topics
topple	topples	toppled	toppling
torment	torments	tormented	tormenting	tormenter	tormenters	tormentor	tormentors
torrent	torrents	torrential
toss	tosses	tossed	tossing
total	totaled	totaling	totalled	untotalled	totalling	totally	totals	totality
totter	totters	tottered	tottering	totterer	totterers
touch	touched	touches	touching	untouched	touchable	untouchable	untouchables
touchy	touchier	touchiest	touchiness	touchily
toward	towards
towel	towels	towelette	towelettes	towelling	towellings
town	towns
townsfolk
township	townships
trace	traced	traces	tracing	traceable	untraceable
track	tracks	tracking	tracked	tracker	trackers	trackless
trade	traded	trades	trading	trader	traders
trademark	trademarks
trail	trailed	trails	trailing
train	trained	trainer	untrained	trainers	training	trains	trainee	trainees
traitor	traitors	traitorous	traitorously
trance	trances
transact	transacts	transacted	transacting	transaction	transactions
transcribe	transcribes	transcribed	transcribing	transcriber	transcribers
transcript	transcripts	transcription	transcriptions
transfer	transferable	transferability	transference	transferred	transferring	transfers	transferral	transferrals	transferor	transferors	transferer	transferee	transferees	transferers
transform	transformation	transformations	transformational	transformed	transforming	transforms	transformer	transformers
translate	translating	translates	translated	translation	translations	translator	translators
transparent	transparently	nontransparent
trap	traps	trapping	trapped	trapper	trappers
trash	trashes	trashy	trashier	trashiest	trashiness
travail	travails
travel	traveled	traveling	travelled	traveller	travellers	travelling	travels	traveler	travelers
treachery	treacheries	treacherous	treacherousness	treacherously
tread	trod	treads	treading
treat	treats	treating	treated	treatable	untreated	treatment	treatments	pretreatment
treble	trebles	trebled	trebling
tree	trees	treeless
tremble	trembles	trembled	trembling
tremendous	tremendously
tremulous	tremulousness	tremulously
trepidation	trepidations
trespass	trespasses	trespassed	trespassing	trespasser	trespassers
trick	tricks	tricked	tricking	tricky	trickier	trickiest	trickiness	trickily	trickery	trickeries	trickster	tricksters
trickle	trickles	trickled	trickling
trifle	trifles	trifling	trifled
trigger	triggered	triggering	triggers
trim	trimming	trimmings	trimmed	trims	trimmer	trimmers
trip	trips	tripping	tripped
triumph	triumphed	triumphing	triumphs
triumphant	triumphantly
trot	trotting	trotted	trots	trotter	trotters
trouble	troubled	untroubled	troubles	troubling	troublesome	troublemaker	troublemakers
truck	trucks	trucked	trucking	trucker	truckers
true	truthful	truthfully	truth	truest	truer	truism	truisms	truthfulness	truly	truths	untrue	untruth	untruthful	untruthfully	untruths	untruthfulness
trunk	trunks
trust	trusted	trusting	entrust	entrusted	entrusting	entrusts	trusts	trusty	trustier	trustiest
try	tried	untried	tries	trying
tub	tubs	tubful
tuck	tucked	untucked	tucking	tucks
tug	tugging	tugged	tugs
tumble	tumbles	tumbled	tumbling	tumbler	tumblers
tumult	tumults	tumultuous	tumultuously
turkey	turk	turks	turkish
turn	turned	turning	turns
tutelage	tutelages
twelve	twelves	twelfth	twelfths
twenty	twenties	twentieth
twilight	twilights
twinkle	twinkles	twinkled	twinkling
twist	twists	twisting	twisted	untwisted
twitch	twitchy	twitchily
twixt
two	twice	twos
type	typed	types	typing	typist	typists	subtype	subtypes
u
ugly	ugliness	ugliest	uglier
unanimity	unanimities
unanimous	unanimously
uncanny	uncannier	uncanniest	uncannily
uncouth	uncouthly	uncouthness
unctuous	unctuously	unctuousness
under	underneath
undergo	undergoes	undergoing	undergone	underwent
underline	underlined	underlines	underlining
understand	understanding	understandings	understands	understood	understandable	understandably	misunderstand	misunderstands	misunderstood	misunderstanding	misunderstandings
ungainly	ungainlier	ungainliest	ungainliness
unheeded
uniform	uniforms	uniformed	uniformity	uniformly
unite	united	unites	uniting	unity	reunite	reunites	reunited	reuniting
unkempt
unless
unnerve	unnerves	unnerved	unnerving
unshod	shod
until	til	till
unwind	unwound	unwinds	unwinding
up	ups	upside
update	updates	updated	updating
upheaval	upheavals
uplift	uplifting	uplifted	uplifts
upon
upper
upright	uprightly
upturn	upturns	upturned
upwards	upward	upwardly
urge	urging	urges	urged
urgent	urgently	urgency	nonurgent
use	misused	misuse	misusing	misuses	misuser	misusers	used	unused	useful	usefulness	useless	uselessness	uselessly	uses	using	usefully	user	users	usable	usability	unusable	reuse	reuses	reused	reusing
usual	usually	unusual	unusually
utter	utters	uttered	uttering	utterance	utterances	unuttered
utterly
v
vacancy	vacancies
vacant	vacantly
vagary	vagaries
vague	vaguely	vagueness
vain	vainer	vainest	vainly
valid	invalidate	invalidity	validate	validated	validating	validation	validity	validly	invalid
valley	valleys
value	valuable	valuables	valuation	revalues	revalued	revaluing	revaluation	revaluations	valuations	valued	valuer	valueless	values	valuing	invaluable	invaluably
vanilla	vanillas
vanish	vanished	vanishes	vanishing
vanity	vanities
vantage	vantages
variety	varieties
various	variously
vary	invariable	invariably	variability	variable	variables	variably	variance	variant	variants	variation	variations	varied	varies	varying
vast	vastly	vastness
vaulting	vaultings	vaulted
vegetable	vegetables	veg	vegs	veggies
vehement	vehemently	vehemence
veil	veiled	veils	veiling	unveil	unveils	unveiled	unveiling
vein	veins	veined
velvet	velvets	velvety	velvetier	velvetiest
veneer	veneers
vengeance	vengeances
venom	venoms	venomous	venomously	nonvenomous	envenom	envenoms	envenomed	envenoming
venture	ventured	ventures	venturing
verbal	verbally	nonverbal	verbalize	verbalizes	verbalized	verbalizing	verbalise	verbalises	verbalised	verbalising	verbalisation	verbalizations
verdict	verdicts
veritable	veritably
vernacular	vernaculars
version	versions
very
veteran	veterans
vex	vexes	vexed	vexing	vexation	vexatious
vice	vices
vicious	viciousness	viciously
victory	victories	victorious	victor	victors
view	viewed	viewing	views	viewer	viewers
viewpoint	viewpoints
vigil	vigils	vigilant	vigilance	vigilances
vigorous	vigorously
village	villager	villagers	villages
vindicate	vindicates	vindicated	vindicating	vindication
vinegar	vinegars	vinegary
violate	violates	violated	violating	violation	violations
violent	violently	violence	nonviolent
violet	violets
virgin	virginity	virginal	virgins
virile	virility	virilities
virus	viruses
visible	visibly	invisible	invisibly	visibility	invisibility
vision	visions	visionary
visit	visited	visiting	visitor	visitors	visits	visitation
visual	visualise	visualised	visualising	visualisation	visualize	visualized	visualizing	visualization	visually
vivid	vividly	vividness
vocabulary	vocabularies
voice	voiced	voices	voicing	voiceless
void	voids	voided	voiding	voidable
voluble	volubly
volume	volumes	vol	vols
volunteer	volunteering	volunteered	volunteers
vouchsafe	vouchsafes	vouchsafed	vouchsafing
w
wad	wadding	wadded	wads
wade	wades	waded	wading	wader	waders
waggle	waggles	waggled	waggling
waif	waifs
wainscot	wainscoting	wainscotting
waist	waists
waistcoat	waistcoats
wait	waited	waiting	waits	waiter	waiters	waitress	waitresses
wake	woke	waking	wakes	waken	woken	wakeful	wakefulness
walk	walked	walking	walks	walker	walkers	walkable
wall	walled	walls
wander	wanders	wandering	wanderings	wandered	wanderer	wanderers
want	wanted	wanting	wants	unwanted	wanna
warm	warms	warmly	warming	warmed	warmth	warmer	warmest
warn	warned	warning	warnings	warningly	warns
warranty	warranties
wary	warier	wariest	wariness	unwary	unwarier	unwariest	unwariness	unwarily	warily
wash	washed	washes	washing	unwashed	washer	washers	washable	unwashable
waste	wasted	wastes	wasting	wasteful	wastefully	wastage	wastages
watch	watched	watches	watching	watcher	watchers
water	watered	waters	watering	watery	waterier	wateriest	wateriness
waterfront	waterfronts
wave	waved	waves	waving
waver	wavers	wavered	wavering	unwavering	waverer	waverers
wax	waxes	waxy	waxier	waxiest	waxiness	waxen	waxed	waxing	unwaxed
way	ways
we	our	ours	ourselves	us
weak	weaker	weakest	weakly	weakness	weaknesses	weaken	weakens	weakening	weakened
wealth	wealthier	wealthiest	wealthiness	wealthy
wear	wearing	wears	wore	worn	unworn	wearable	unwearable	wearer	wearers
weary	wearied	wearies	wearier	weariest	weariness	wearily
weather	weathers	weathering	weathered
weave	wove	woven	weaving	weaves	weaved	weaver	weavers
web	webs	webbed	webbing	webbings
wedge	wedges	wedged	wedging
weed	weeds	weedless	weedy	weedier	weediest	weeded	weeding
week	weekend	weekends	weekly	weeks	midweek	midweekly
weep	wept	weeps	weeping	weeper	weepers
weigh	weights	weight	weighs	weighing	weighed	unweighed	weighted	weighting	weightings	weightless	weightlessness	weighty	weightier	weightiest	weightiness	weightily
welcome	welcomed	welcomes	welcoming	unwelcome
well	unwell	wells	welled	welling
welt	welts
wend	wends	wended	wending
west	westerly	westerlies	westward	westwards	midwest	midwestern
western	westerner	westerners	westerns
wet	wetting	wets	wetted	wetness	wetly	wetter	wettest
what	whatever	wot	whatcha	whaddya
whatsoever
wheedle	wheedles	wheedled	wheedling	wheedler	wheedlers
wheel	wheels	wheeler	wheeled	wheeling
when	whenever
whence
where	wherever
whet	whetting	whetted	whets
whether
which	whichever
while	whilst
whimper	whimpers	whimpered	whimpering
whimsy	whimsies	whimsical	whimsically	whimsicality	whimsicalities
whine	whines	whined	whining	whiner	whiners
whip	whipping	whipped	whips
whir	whirring	whirred	whirs
whirl	whirls	whirled	whirling
whirlwind	whirlwinds
whisper	whispers	whispered	whispering	whisperer	whisperers
whistle	whistles	whistled	whistling	whistler	whistlers
white	whiteness	whiter	whitest	whitish	whites	whiten	whitening	whitens	whitened	whitener	whiteners
who	whoever	whom	whose
whoa
whole	wholes	wholeness	wholly	wholistic	wholistically
why
wick	wicks
wicked	wickeder	wickedest	wickedness	wickedly
wide	widely	widen	widens	widened	wideness	widening	wider	widest	width	widths
wife	wives
wild	wilder	wildest	wildly	wildness
will	ll	wo	willing	willingness	unwillingness	willingly	unwilling	unwillingly	willed
win	winner	winners	winning	winnings	wins	won
wince	winces	winced	wincing
wind	winded	winds	windy	winding	winder	winders
window	windows	windowless
windowsill	windowsills
wing	wings	winging	winged
wink	winks	winked	winking	winker	winkers
winter	winters	wintry	midwinter	wintered	wintering
wipe	wiping	wipes	wiped	unwiped	wiper	wipers
wire	wires	wired	wiring	wirings
wise	unwise	unwisely	wisdom	wisely	wiseness	wiser	wisest
wish	wished	wishes	wishing
wisp	wisps	wispy	wispier	wispiest
wistful	wistfulness	wistfully
wit	wittily	witty	wits
with	wiv
withal
withdraw	withdrawal	withdrawals	withdrawing	withdraws	withdrew	withdrawn
within
without
witless	witlessly	witlessness
witness	witnessing	witnesses	witnessed	unwitnessed
woe	woes	woeful	woefulness	woefully
woman	women	womanly
womanhood	womanhoods
wonder	wondered	wonderful	wondering	wonderingly	wonders	wonderfully	wondrous	wondrously	wonderment
wood	woods	wooden	woodland	woodlands	woody
woodwork	woodworks	woodworking	woodworker	woodworkers
word	words	worded	wording	wordy	wordless	wordlessly
work	worked	worker	workers	working	workings	works	workman	workmen	workable	unworkable
workshop	workshops
world	worlds	worldly	unworldly	worldliness	unworldliness
worry	worrying	worries	worried	worriedly	worryingly	worriedness
worse	worst	worsen	worsens	worsened	worsening
worship	worshipping	worships	worshipped	worshipper	worshippers
worth	worthy	worthier	worthiest	unworthy	worthless	worthwhile
would	wouldn
wound	wounds	wounded	unwounded	wounding
wraith	wraiths
wrangle	wrangles	wrangled	wrangler	wranglers	wrangling	wranglings
wrap	wrapping	wraps	wrapper	wrappers	wrapped	unwrap	unwrapped	unwraps	unwrapping
wrath	wraths	wrathful	wrathfully
wreck	wrecks	wrecked	wrecking	wrecker	wreckers	wreckage	wreckages
wrench	wrenches	wrenched	wrenching
wrestle	wrestles	wrestled	wrestling	wrestler	wrestlers
wrinkle	wrinkled	unwrinkled	wrinkling	wrinkly	wrinkles
wrist	wrists
write	writer	writers	writes	writing	writings	written	unwritten	wrote	rewrite	rewrote	rewritten	rewrites	rewriting	rewrit
wrong	wronged	wronging	wrongs	wrongly	wrongful	wrongfulness	wrongfully
wrought
x
yard	yards	yd	yds
yawn	yawns	yawned	yawning	yawner	yawners
year	years	yearly	yr	yrs	yearling	yearlings
yearn	yearns	yearned	yearning
yell	yells	yelled	yelling
yellow	yellowish	yellowness	yellowed	yellowing	yellows	yellower	yellowest
yelp	yelps	yelped	yelping
yes	yeses	ya	yah	yeah	yeh	yea	yep	yup
yesterday	yesterdays
yet
yield	yields	yielded	yielding	unyielding
yip	yips	yipped	yipping
yon
you	your	yourselves	yourself	yours	ye	yer	yerself	yous
young	younger	youngster	youngest	youngsters	youngish
youth	youths	youthful	youthfully
zeal	zeals	zealous	zealousness	zealously
zest	zests	zesty	zestier	zestiest	zestful	zestfulness	zestfully
zip	zips	zipped	zipping	zipper	zippers	unzip	unzipping	unzipped	unzips